ID,Games,Wins,Home Wins,Away Wins,Neutral Wins,Losses,Home Losses,Away Losses,Neutral Losses
L556,27,7,6,1,0,20,9,10,1
L557,28,15,8,5,2,13,4,7,2
L554,33,22,11,8,3,11,2,6,3
L555,28,9,4,5,0,19,9,9,1
L552,28,7,3,3,1,21,8,12,1
L553,26,11,8,3,0,15,5,10,0
L550,27,4,2,2,0,23,9,13,1
L551,31,21,13,6,2,10,4,5,1
L558,27,15,9,5,1,12,4,8,0
L559,31,17,15,2,0,14,5,8,1
O540,28,17,10,7,0,11,3,7,1
O541,32,15,7,5,3,17,5,10,2
O542,26,6,2,2,2,20,8,12,0
O543,27,6,3,3,0,21,9,11,1
O544,30,12,8,3,1,18,4,13,1
O545,26,9,7,2,0,17,3,14,0
O546,31,19,10,7,2,12,5,7,0
O547,31,13,9,2,2,18,5,11,2
O548,28,6,4,0,2,22,4,17,1
O549,33,18,12,2,4,15,4,9,2
B617,26,10,8,2,0,16,5,9,2
B616,27,8,5,3,0,19,9,10,0
B615,26,11,6,5,0,15,4,10,1
B613,27,20,15,5,0,7,3,3,1
B612,25,16,7,9,0,9,4,4,1
B611,28,17,8,9,0,11,5,6,0
B610,27,8,5,2,1,19,7,12,0
B619,26,7,6,1,0,19,6,12,1
H648,28,9,3,6,0,19,7,11,1
H646,26,6,6,0,0,20,6,11,3
H647,26,4,4,0,0,22,8,14,0
H644,26,14,9,4,1,12,2,9,1
H645,29,14,11,3,0,15,5,10,0
H642,27,11,7,3,1,16,5,10,1
H643,26,12,9,3,0,14,3,11,0
H640,32,29,12,10,7,3,1,1,1
H641,29,12,9,3,0,17,5,10,2
P646,29,16,9,7,0,13,2,11,0
P647,31,20,9,7,4,11,2,6,3
P644,31,16,9,7,0,15,5,10,0
P645,29,16,9,5,2,13,4,9,0
P642,31,12,7,5,0,19,6,12,1
P643,26,9,4,4,1,17,5,11,1
P640,33,25,15,3,7,8,0,7,1
P641,33,15,8,5,2,18,10,5,3
P648,32,27,14,13,0,5,2,3,0
P649,27,8,6,1,1,19,4,14,1
L835,32,21,11,8,2,11,3,6,2
L834,28,5,3,1,1,23,9,11,3
L839,31,15,12,2,1,16,5,10,1
L838,29,10,6,4,0,19,7,12,0
A647,27,16,9,7,0,11,3,6,2
E740,27,17,8,8,1,10,1,7,2
E741,30,5,1,2,2,25,10,12,3
E742,25,3,3,0,0,22,8,13,1
E743,30,18,9,8,1,12,6,6,0
E744,30,16,9,4,3,14,3,10,1
E745,29,17,8,7,2,12,3,6,3
E746,30,15,9,3,3,15,6,6,3
E747,33,20,8,8,4,13,4,9,0
E749,31,19,10,6,3,12,3,7,2
N657,29,8,4,3,1,21,8,11,2
N655,33,26,19,6,1,7,2,3,2
N654,31,14,8,5,1,17,7,9,1
N653,32,12,5,6,1,20,8,10,2
N652,31,3,3,0,0,28,10,15,3
N651,33,28,16,8,4,5,2,1,2
N650,32,15,8,5,2,17,4,11,2
N659,33,10,7,1,2,23,7,13,3
N658,30,16,9,7,0,14,5,7,2
P700,29,11,6,4,1,18,5,12,1
M748,28,7,6,1,0,21,8,13,0
M749,31,17,12,3,2,14,3,9,2
M740,28,8,6,2,0,20,5,15,0
M741,32,21,11,5,5,11,4,6,1
M742,30,3,1,1,1,27,12,13,2
M743,30,16,9,6,1,14,6,7,1
M744,33,23,11,9,3,10,2,6,2
M745,33,26,11,14,1,7,4,2,1
M746,31,11,8,3,0,20,10,10,0
M747,32,12,7,3,2,20,5,11,4
L769,30,14,10,4,0,16,7,8,1
L768,29,18,9,7,2,11,3,7,1
L761,28,14,6,5,3,14,3,9,2
L762,30,10,5,5,0,20,8,10,2
L765,26,12,7,5,0,14,5,8,1
L764,28,12,10,1,1,16,5,9,2
L767,29,12,7,3,2,17,7,9,1
L766,32,20,10,8,2,12,4,7,1
F668,28,16,12,4,0,12,4,7,1
F669,33,17,10,4,3,16,4,9,3
F662,31,21,11,7,3,10,3,4,3
F663,30,15,7,7,1,15,4,10,1
F660,29,15,10,4,1,14,6,7,1
F661,25,16,11,5,0,9,1,7,1
F666,30,16,9,5,2,14,5,6,3
F667,28,13,6,7,0,15,7,7,1
F664,29,21,12,8,1,8,1,6,1
F665,28,12,7,5,0,16,3,12,1
A551,28,18,14,4,0,10,2,8,0
C783,29,25,12,9,4,4,2,2,0
C780,31,21,13,7,1,10,2,4,4
M810,33,30,15,9,6,3,2,1,0
M811,29,14,7,6,1,15,6,8,1
M812,28,7,3,3,1,21,7,14,0
A552,26,5,5,0,0,21,9,12,0
M814,28,19,12,7,0,9,3,6,0
M815,31,19,10,7,2,12,3,8,1
M816,33,20,12,5,3,13,3,9,1
M817,32,25,19,6,0,7,2,5,0
M818,32,21,10,7,4,11,5,4,2
M819,28,17,10,4,3,11,3,8,0
A554,25,22,12,10,0,3,1,2,0
A557,27,16,9,6,1,11,4,6,1
A556,27,9,8,1,0,18,8,10,0
J718,29,11,5,3,3,18,5,13,0
J719,31,21,13,4,4,10,1,9,0
J712,30,21,10,8,3,9,2,6,1
J713,26,9,6,1,2,17,4,11,2
J711,26,12,7,4,1,14,7,7,0
J716,29,17,11,6,0,12,2,8,2
J717,28,17,13,4,0,11,4,6,1
J714,30,20,12,6,2,10,2,7,1
J715,31,15,12,1,2,16,4,9,3
B744,27,14,7,6,1,13,4,9,0
C610,26,14,8,6,0,12,3,9,0
C611,26,14,8,6,0,12,5,7,0
C612,25,12,6,6,0,13,6,7,0
C613,27,19,15,4,0,8,4,4,0
C615,28,16,10,5,1,12,3,8,1
C616,27,7,2,4,1,20,8,12,0
C617,29,9,6,3,0,20,7,10,3
C619,28,8,6,2,0,20,8,12,0
O818,30,16,11,2,3,14,5,9,0
O819,26,12,7,4,1,14,5,7,2
O816,31,9,4,4,1,22,9,10,3
O817,32,24,14,9,1,8,4,3,1
O814,28,12,8,4,0,16,5,10,1
O815,31,8,4,3,1,23,11,11,1
O812,29,10,6,3,1,19,6,12,1
O813,30,4,0,4,0,26,13,12,1
O810,32,14,10,3,1,18,6,7,5
O811,28,12,9,3,0,16,3,12,1
H789,30,15,8,5,2,15,4,10,1
H788,28,9,7,2,0,19,7,12,0
H783,31,23,14,7,2,8,3,3,2
H782,29,10,6,3,1,19,6,8,5
H781,29,14,8,3,3,15,6,8,1
H780,29,16,11,3,2,13,4,8,1
H787,26,11,6,4,1,15,4,11,0
H786,29,24,17,6,1,5,0,3,2
H785,26,11,8,3,0,15,5,9,1
H784,26,6,4,1,1,20,7,12,1
G619,31,18,11,4,3,13,2,10,1
G614,28,9,6,1,2,19,8,10,1
G615,32,12,6,1,5,20,5,11,4
G616,32,18,9,6,3,14,3,7,4
G617,31,17,9,6,2,14,5,6,3
G610,31,25,10,11,4,6,0,4,2
G611,32,14,8,5,1,18,5,9,4
G612,26,14,9,4,1,12,3,9,0
G613,32,27,16,7,4,5,1,3,1
E685,27,6,4,2,0,21,5,14,2
E687,31,22,10,8,4,9,2,4,3
E686,29,9,5,3,1,20,6,12,2
E681,25,8,7,0,1,17,4,10,3
E680,26,15,9,6,0,11,5,5,1
E683,29,5,4,1,0,24,7,14,3
E682,24,6,3,3,0,18,7,11,0
I825,30,23,12,8,3,7,2,5,0
I824,29,22,14,6,2,7,1,5,1
I827,30,21,15,4,2,9,2,6,1
I826,29,17,10,4,3,12,5,6,1
I821,31,23,14,6,3,8,1,5,2
I820,28,16,8,7,1,12,5,4,3
I822,27,24,14,10,0,3,0,2,1
I829,30,15,6,5,4,15,7,6,2
I828,30,22,10,10,2,8,2,5,1
B587,31,17,12,5,0,14,4,7,3
B586,25,5,4,1,0,20,6,13,1
B583,26,16,9,7,0,10,2,6,2
B582,25,6,4,2,0,19,8,11,0
B581,29,19,8,7,4,10,2,7,1
B580,25,7,7,0,0,18,5,12,1
B589,29,11,4,7,0,18,7,11,0
B588,28,18,10,8,0,10,4,6,0
B855,26,8,4,4,0,18,8,10,0
B854,25,9,4,3,2,16,7,9,0
O568,29,14,8,5,1,15,4,5,6
O569,32,20,15,4,1,12,2,7,3
O566,28,7,3,4,0,21,8,12,1
O567,27,4,4,0,0,23,10,13,0
O564,29,14,6,7,1,15,5,6,4
O565,32,11,7,2,2,21,6,13,2
O562,31,16,13,3,0,15,2,9,4
O563,29,7,5,2,0,22,6,16,0
O560,27,5,4,1,0,22,6,15,1
O561,29,25,9,13,3,4,1,3,0
B639,25,7,4,3,0,18,7,10,1
B635,28,15,8,5,2,13,6,6,1
B634,25,9,5,4,0,16,8,8,0
B637,27,10,9,1,0,17,7,10,0
B636,32,31,17,10,4,1,0,1,0
B633,28,5,3,2,0,23,9,14,0
B632,28,13,10,3,0,15,3,12,0
I599,29,18,12,5,1,11,2,8,1
I598,26,14,8,6,0,12,4,7,1
I595,30,17,14,2,1,13,2,10,1
I594,25,3,3,0,0,22,9,13,0
I597,28,13,7,6,0,15,9,6,0
I596,28,6,5,1,0,22,7,14,1
I590,26,7,4,3,0,19,8,10,1
I593,30,14,8,3,3,16,4,12,0
I592,30,20,11,4,5,10,4,5,1
L844,31,16,9,6,1,15,5,10,0
L845,31,9,7,2,0,22,7,15,0
L846,30,16,10,5,1,14,4,7,3
L847,30,15,11,4,0,15,5,9,1
L840,32,19,17,1,1,13,2,10,1
L841,32,25,12,8,5,7,2,4,1
L842,28,17,11,5,1,11,2,8,1
L843,30,21,13,3,5,9,1,6,2
L848,28,24,11,12,1,4,0,3,1
L849,34,29,19,7,3,5,0,3,2
E768,30,20,12,7,1,10,2,7,1
E769,32,15,10,2,3,17,6,8,3
E766,31,23,15,8,0,8,2,5,1
E767,28,20,12,7,1,8,2,5,1
E764,29,20,13,6,1,9,3,4,2
E765,25,4,1,3,0,21,11,9,1
E762,28,22,12,7,3,6,1,5,0
E761,25,8,5,3,0,17,6,11,0
R661,31,12,11,1,0,19,4,11,4
N679,31,8,6,1,1,23,8,14,1
N678,31,11,9,2,0,20,8,11,1
N675,34,22,12,5,5,12,5,5,2
N674,31,16,12,3,1,15,4,7,4
N677,31,7,3,3,1,24,9,13,2
N676,34,28,18,5,5,6,0,4,2
N671,32,26,12,9,5,6,2,1,3
N670,32,19,13,3,3,13,3,8,2
N673,31,21,15,4,2,10,3,6,1
N672,31,17,9,6,2,14,6,7,1
M766,32,22,13,8,1,10,4,6,0
M767,29,9,7,2,0,20,10,9,1
M764,32,17,11,4,2,15,6,8,1
M765,27,22,10,11,1,5,1,3,1
M762,29,10,5,4,1,19,6,12,1
M760,28,6,3,3,0,22,5,13,4
M761,26,13,7,6,0,13,4,8,1
M768,31,25,16,7,2,6,1,4,1
M769,32,14,8,3,3,18,9,6,3
F600,28,13,6,5,2,15,4,10,1
F601,7,1,0,1,0,6,0,6,0
F602,29,18,10,6,2,11,1,9,1
F603,30,23,13,7,3,7,3,3,1
F604,30,16,9,5,2,14,4,8,2
F605,31,27,15,10,2,4,0,4,0
F606,29,17,13,3,1,12,4,8,0
F607,29,23,12,9,2,6,1,5,0
F608,26,8,5,3,0,18,4,14,0
M838,31,23,13,10,0,8,3,5,0
M839,30,17,15,2,0,13,2,10,1
M836,32,20,11,7,2,12,1,9,2
M837,28,10,7,2,1,18,5,12,1
M834,28,10,8,2,0,18,4,13,1
M835,31,25,12,9,4,6,1,3,2
M832,25,10,4,6,0,15,6,7,2
M833,30,9,7,1,1,21,6,13,2
M830,30,15,11,4,0,15,6,7,2
M831,32,19,12,4,3,13,2,8,3
I698,28,16,14,2,0,12,3,8,1
I699,30,22,14,5,3,8,0,8,0
I695,29,20,14,5,1,9,2,6,1
I692,26,3,1,2,0,23,12,10,1
I693,28,3,3,0,0,25,7,16,2
I690,27,8,6,1,1,19,5,12,2
J771,29,13,8,2,3,16,5,10,1
J772,25,8,5,1,2,17,6,9,2
J773,27,12,9,2,1,15,2,12,1
J774,26,11,8,3,0,15,3,11,1
J775,28,2,1,0,1,26,11,11,4
J776,28,13,8,5,0,15,4,11,0
J777,27,14,10,4,0,13,2,11,0
J778,27,9,9,0,0,18,7,11,0
J779,30,19,9,5,5,11,1,7,3
D690,26,6,5,0,1,20,7,13,0
D693,27,12,8,3,1,15,3,11,1
D692,25,18,10,7,1,7,2,4,1
D695,31,18,14,1,3,13,3,8,2
D699,25,7,5,2,0,18,8,10,0
D698,31,19,11,6,2,12,4,6,2
K737,27,12,9,3,0,15,7,8,0
K736,26,12,7,5,0,14,5,8,1
K734,27,3,3,0,0,24,7,15,2
K733,26,10,4,5,1,16,5,10,1
K732,28,11,7,4,0,17,5,9,3
K731,31,24,16,5,3,7,1,5,1
K730,27,7,6,1,0,20,6,13,1
K739,27,11,7,3,1,16,5,10,1
K738,28,9,9,0,0,19,5,12,2
C639,27,11,8,3,0,16,3,10,3
C636,36,33,18,8,7,3,0,3,0
C637,28,17,14,2,1,11,2,8,1
C634,24,10,7,3,0,14,4,10,0
C635,27,11,6,5,0,16,7,7,2
C632,25,12,8,4,0,13,2,11,0
C633,27,8,5,3,0,19,9,10,0
N842,29,20,9,9,2,9,3,4,2
N843,34,23,11,7,5,11,3,5,3
N840,33,25,18,6,1,8,1,4,3
N841,32,17,9,5,3,15,7,6,2
N846,32,16,13,1,2,16,3,10,3
N847,29,9,6,2,1,20,8,11,1
N844,31,22,13,7,2,9,1,7,1
N845,30,16,11,3,2,14,3,10,1
N848,29,10,6,4,0,19,6,12,1
N849,31,19,13,4,2,12,3,7,2
C841,27,8,5,3,0,19,7,9,3
E693,28,14,6,6,2,14,3,10,1
E690,27,12,7,4,1,15,4,11,0
O607,31,25,13,6,6,6,1,3,2
O606,33,21,13,3,5,12,2,8,2
A799,27,15,6,8,1,12,4,7,1
A798,29,15,9,6,0,14,6,6,2
O603,33,23,12,6,5,10,4,5,1
O602,31,17,11,5,1,14,4,7,3
O601,26,5,2,3,0,21,10,11,0
O600,30,7,6,1,0,23,6,16,1
A793,29,20,10,9,1,9,4,4,1
A792,25,10,4,4,2,15,5,9,1
A791,27,15,6,6,3,12,2,8,2
A790,28,14,11,2,1,14,5,8,1
A797,24,10,7,3,0,14,2,11,1
A796,29,28,13,11,4,1,0,0,1
A795,24,9,5,3,1,15,5,9,1
A794,27,11,7,2,2,16,4,11,1
E695,29,17,15,2,0,12,4,8,0
A537,24,4,1,3,0,20,10,9,1
A536,28,15,11,4,0,13,4,8,1
A535,26,18,9,9,0,8,2,4,2
A534,28,13,8,4,1,15,4,8,3
A533,26,15,6,7,2,11,2,8,1
A531,26,10,4,5,1,16,6,8,2
A530,29,22,12,7,3,7,1,4,2
A539,27,17,11,6,0,10,3,7,0
A538,25,12,7,4,1,13,3,8,2
M599,26,9,8,1,0,17,4,12,1
M598,30,7,5,1,1,23,6,13,4
M591,31,10,4,5,1,21,7,13,1
M590,33,15,11,3,1,18,4,11,3
M593,30,13,7,5,1,17,3,11,3
M592,32,21,15,3,3,11,4,6,1
M595,33,19,13,4,2,14,4,6,4
M594,28,8,7,1,0,20,9,11,0
M597,31,12,10,2,0,19,6,12,1
M596,28,11,7,4,0,17,7,9,1
G639,31,26,11,11,4,5,0,3,2
G632,28,9,6,3,0,19,7,12,0
G633,28,16,9,7,0,12,3,6,3
G630,24,3,2,1,0,21,4,16,1
G631,28,13,6,4,3,15,5,8,2
G636,30,27,12,10,5,3,0,1,2
G637,29,13,12,0,1,16,5,10,1
G634,29,13,7,5,1,16,5,10,1
G635,29,14,7,4,3,15,5,9,1
I843,28,15,9,3,3,13,4,7,2
I842,27,13,6,5,2,14,5,8,1
I841,28,12,5,5,2,16,5,8,3
I840,30,19,11,6,2,11,3,7,1
I847,28,7,5,1,1,21,7,13,1
I846,30,20,10,7,3,10,4,4,2
I845,28,18,9,8,1,10,3,7,0
I844,27,16,10,6,0,11,3,8,0
I849,30,24,15,5,4,6,0,6,0
I848,26,14,8,5,1,12,4,7,1
B839,29,23,12,10,1,6,3,2,1
B838,27,10,7,3,0,17,8,8,1
B836,28,14,9,5,0,14,4,9,1
B835,26,11,6,5,0,15,5,10,0
B834,27,17,8,9,0,10,4,5,1
B833,24,11,7,4,0,13,1,12,0
B832,25,9,5,4,0,16,5,11,0
B831,30,14,10,3,1,16,4,8,4
B830,30,18,11,4,3,12,3,8,1
I832,26,4,4,0,0,22,6,13,3
I833,24,9,5,3,1,15,5,10,0
I830,29,17,13,3,1,12,4,7,1
I831,29,15,11,3,1,14,4,8,2
I836,30,26,13,8,5,4,0,4,0
I835,26,13,8,5,0,13,4,8,1
A645,27,15,6,5,4,12,3,7,2
L598,29,13,7,5,1,16,5,10,1
L599,31,23,13,6,4,8,1,5,2
A644,26,3,3,0,0,23,7,13,3
L592,34,29,18,5,6,5,0,4,1
L593,31,18,8,6,4,13,2,9,2
L590,30,15,10,5,0,15,2,12,1
L596,30,18,11,6,1,12,3,7,2
L597,31,22,15,7,0,9,3,5,1
L594,27,10,7,3,0,17,4,13,0
L595,32,20,14,4,2,12,3,8,1
J806,27,10,4,4,2,17,7,8,2
J807,28,15,8,6,1,13,4,8,1
A643,25,10,9,1,0,15,4,10,1
A642,25,7,7,0,0,18,3,13,2
B659,28,6,5,1,0,22,9,13,0
B658,27,9,7,2,0,18,6,12,0
B653,27,13,8,5,0,14,5,9,0
B652,27,6,4,2,0,21,9,12,0
B651,31,23,11,7,5,8,3,4,1
B650,27,14,6,8,0,13,4,9,0
B657,28,10,4,6,0,18,7,8,3
B655,30,10,9,0,1,20,6,10,4
B654,27,12,8,4,0,15,5,10,0
P688,29,19,12,6,1,10,0,9,1
P689,27,12,8,2,2,15,3,11,1
P682,31,22,12,8,2,9,1,8,0
P683,31,17,10,4,3,14,2,10,2
P680,29,19,11,7,1,10,1,9,0
P681,29,11,7,2,2,18,4,14,0
P686,32,11,8,3,0,21,5,16,0
P687,29,21,11,9,1,8,2,3,3
P685,32,13,7,5,1,19,2,14,3
N619,31,8,8,0,0,23,5,14,4
N618,29,4,2,1,1,25,7,15,3
N613,30,13,11,2,0,17,9,7,1
N612,27,13,6,7,0,14,6,8,0
N611,33,7,4,1,2,26,8,16,2
N610,31,15,5,6,4,16,6,8,2
N617,32,21,12,6,3,11,3,7,1
N616,32,18,12,6,0,14,4,10,0
N615,31,20,9,8,3,11,3,6,2
N614,27,6,2,4,0,21,10,11,0
H574,29,17,9,6,2,12,3,7,2
H575,28,8,5,2,1,20,7,11,2
D596,27,12,9,2,1,15,4,9,2
H577,30,24,15,3,6,6,0,6,0
H570,29,15,8,5,2,14,5,8,1
H571,27,15,11,4,0,12,0,11,1
H572,32,17,10,2,5,15,3,9,3
H573,28,16,13,3,0,12,3,8,1
M784,31,15,10,5,0,16,2,10,4
M785,30,7,4,2,1,23,9,13,1
M786,32,19,14,4,1,13,5,6,2
M787,29,9,5,3,1,20,9,10,1
M780,31,16,11,3,2,15,5,9,1
M781,30,24,14,6,4,6,1,5,0
M782,30,6,5,1,0,24,9,14,1
M783,33,26,16,7,3,7,1,5,1
F628,33,22,12,4,6,11,4,6,1
F629,29,24,15,6,3,5,0,4,1
F626,31,20,12,4,4,11,2,8,1
F627,31,21,11,6,4,10,2,6,2
F624,29,21,13,7,1,8,2,5,1
F625,33,21,14,4,3,12,2,7,3
F622,28,11,9,2,0,17,6,10,1
F623,31,24,13,7,4,7,0,5,2
F620,25,4,3,1,0,21,9,12,0
F621,26,12,6,5,1,14,6,6,2
R617,30,18,12,5,1,12,4,7,1
R616,30,12,7,4,1,18,5,12,1
R615,31,6,5,1,0,25,9,14,2
R614,28,15,8,6,1,13,5,7,1
R613,30,16,13,3,0,14,6,7,1
R612,27,18,12,6,0,9,1,8,0
R611,30,17,10,7,0,13,4,8,1
R610,31,14,7,7,0,17,7,8,2
R619,29,6,4,2,0,23,6,13,4
R618,28,11,4,3,4,17,5,12,0
J758,30,14,7,4,3,16,7,9,0
J759,28,0,0,0,0,28,12,15,1
J756,29,6,5,1,0,23,9,13,1
J757,29,11,8,2,1,18,4,13,1
J754,27,9,5,3,1,18,9,8,1
J755,29,16,11,4,1,13,3,9,1
J752,26,13,8,4,1,13,3,10,0
J753,27,14,9,4,1,13,3,8,2
J750,27,4,3,1,0,23,8,15,0
J751,26,14,8,5,1,12,2,8,2
D679,25,5,3,2,0,20,9,11,0
D678,30,20,13,7,0,10,4,6,0
D677,29,7,3,2,2,22,9,12,1
D676,28,20,13,6,1,8,3,4,1
D675,32,20,14,2,4,12,2,6,4
D674,30,18,12,3,3,12,3,7,2
D673,27,17,13,4,0,10,3,7,0
D672,29,10,7,3,0,19,7,9,3
D671,33,29,14,11,4,4,0,3,1
D670,31,12,8,2,2,19,5,9,5
K719,29,18,12,5,1,11,2,7,2
K718,27,9,4,4,1,18,7,9,2
K715,28,13,8,3,2,15,5,8,2
K714,30,21,11,7,3,9,3,5,1
K717,28,15,11,4,0,13,5,6,2
K716,29,22,11,10,1,7,0,6,1
K711,25,11,8,3,0,14,4,9,1
K710,26,4,4,0,0,22,7,14,1
K713,28,18,10,6,2,10,2,6,2
K712,29,18,9,5,4,11,2,8,1
L677,30,11,8,1,2,19,4,13,2
L676,30,18,15,3,0,12,4,6,2
L675,31,18,13,3,2,13,3,9,1
L674,32,20,15,2,3,12,1,10,1
L673,31,9,8,1,0,22,9,9,4
L672,31,14,6,7,1,17,6,7,4
L671,33,22,18,1,3,11,1,8,2
L670,33,21,17,3,1,12,3,8,1
L679,30,12,8,3,1,18,5,12,1
L678,31,21,11,8,2,10,4,4,2
H817,31,21,15,6,0,10,5,5,0
H816,30,24,11,10,3,6,1,5,0
H815,28,6,5,1,0,22,8,13,1
H814,29,13,10,2,1,16,2,14,0
H813,27,7,4,1,2,20,6,13,1
H812,27,11,6,5,0,16,5,11,0
H811,28,19,9,8,2,9,1,6,2
H810,29,10,5,4,1,19,10,7,2
H819,27,14,7,6,1,13,4,9,0
H818,30,13,8,3,2,17,6,9,2
N828,31,23,12,9,2,8,3,4,1
N829,33,26,17,8,1,7,2,3,2
N820,29,16,8,6,2,13,3,9,1
N821,32,24,13,6,5,8,1,7,0
N822,33,29,16,11,2,4,0,3,1
N823,26,15,10,4,1,11,4,7,0
N824,31,19,11,6,2,12,4,5,3
N825,33,24,13,7,4,9,1,6,2
N826,29,7,6,1,0,22,6,12,4
N827,31,19,14,3,2,12,4,7,1
O629,32,15,11,3,1,17,7,7,3
O628,32,10,9,1,0,22,9,10,3
O625,31,10,8,1,1,21,9,8,4
O624,32,22,15,6,1,10,2,7,1
O627,31,21,11,8,2,10,3,4,3
O626,30,16,10,5,1,14,3,9,2
O621,27,5,4,1,0,22,6,16,0
O620,29,13,7,6,0,16,6,10,0
O623,33,19,12,6,1,14,4,4,6
O622,29,7,6,1,0,22,7,15,0
A519,27,17,6,7,4,10,4,6,0
A518,30,18,9,4,5,12,4,7,1
A515,30,18,14,3,1,12,4,7,1
A517,24,4,3,0,1,20,6,13,1
A516,26,8,6,2,0,18,6,11,1
A511,30,24,14,8,2,6,3,3,0
A510,26,6,5,0,1,20,6,11,3
A513,27,21,11,8,2,6,1,4,1
A512,27,11,8,3,0,16,9,7,0
H749,30,24,14,8,2,6,0,5,1
H747,30,20,8,9,3,10,2,7,1
H746,28,12,10,2,0,16,6,10,0
H745,26,9,5,4,0,17,5,12,0
H744,28,12,8,4,0,16,6,9,1
H743,28,15,10,5,0,13,4,7,2
H742,27,17,11,6,0,10,2,7,1
H741,29,18,11,6,1,11,4,7,0
H740,30,10,6,4,0,20,5,15,0
G650,27,18,9,9,0,9,2,6,1
G651,30,18,15,2,1,12,2,8,2
G652,28,8,4,3,1,20,9,9,2
G653,28,5,2,2,1,23,9,13,1
G654,30,17,11,4,2,13,2,10,1
G655,31,17,12,2,3,14,4,7,3
G657,30,12,4,5,3,18,7,8,3
G658,28,20,13,5,2,8,1,6,1
G659,28,19,10,9,0,9,4,5,0
P747,28,6,4,1,1,22,6,13,3
P746,32,15,10,3,2,17,6,10,1
P745,32,18,11,7,0,14,2,12,0
P744,33,23,9,11,3,10,5,4,1
P743,34,27,12,10,5,7,3,3,1
P742,30,12,7,3,2,18,7,8,3
P741,32,19,11,6,2,13,4,7,2
P740,26,2,2,0,0,24,8,16,0
P749,32,13,8,3,2,19,8,9,2
P748,29,17,8,8,1,12,5,6,1
B815,30,10,5,4,1,20,8,10,2
B814,27,17,8,9,0,10,2,8,0
B817,29,20,14,6,0,9,3,6,0
B816,29,16,10,4,2,13,2,8,3
B811,28,12,10,2,0,16,4,12,0
B810,28,21,13,8,0,7,3,4,0
B813,26,4,3,1,0,22,9,13,0
B812,27,13,9,4,0,14,4,9,1
B819,25,10,7,3,0,15,3,12,0
B818,27,17,11,6,0,10,2,8,0
M813,31,23,12,9,2,8,1,7,0
F547,28,15,10,3,2,13,2,10,1
F546,31,21,11,7,3,10,2,7,1
F545,27,8,5,2,1,19,8,10,1
F544,28,14,7,7,0,14,6,7,1
F543,24,5,5,0,0,19,3,15,1
F541,31,20,9,7,4,11,2,8,1
F540,28,7,4,3,0,21,7,13,1
F549,32,23,11,7,5,9,3,3,3
F548,27,4,2,2,0,23,9,13,1
B671,27,16,12,4,0,11,4,7,0
B670,30,19,11,7,1,11,3,6,2
B673,29,26,15,9,2,3,0,3,0
B672,28,16,10,5,1,12,1,10,1
B675,29,11,9,1,1,18,4,9,5
B674,28,20,15,4,1,8,2,6,0
B677,25,8,3,5,0,17,9,8,0
B676,32,15,11,0,4,17,5,10,2
B679,29,18,10,8,0,11,3,8,0
B678,32,24,13,7,4,8,1,5,2
A705,26,5,3,2,0,21,6,13,2
L808,29,5,2,2,1,24,8,14,2
L809,29,20,13,5,2,9,1,6,2
N589,32,17,9,6,2,15,4,9,2
N588,30,7,4,3,0,23,9,14,0
L800,29,12,6,3,3,17,5,11,1
L801,28,15,9,5,1,13,4,8,1
L802,29,18,13,4,1,11,3,6,2
N580,28,16,10,5,1,12,1,11,0
N587,29,16,14,2,0,13,3,9,1
N586,32,22,10,8,4,10,2,6,2
L806,28,5,4,1,0,23,7,14,2
L807,33,15,9,3,3,18,3,13,2
N631,27,13,6,7,0,14,5,6,3
N630,29,12,7,5,0,17,5,11,1
N633,31,18,10,8,0,13,5,7,1
N632,33,18,9,6,3,15,0,13,2
N635,33,19,8,7,4,14,4,6,4
N634,26,9,4,5,0,17,6,11,0
N637,31,20,14,5,1,11,3,5,3
N636,32,25,18,6,1,7,0,4,3
N639,32,18,12,5,1,14,3,8,3
N638,28,6,5,1,0,22,8,14,0
H552,30,8,5,2,1,22,8,12,2
H553,26,11,6,5,0,15,4,11,0
H550,24,4,3,1,0,20,8,11,1
H551,28,15,13,1,1,13,4,8,1
H556,31,20,14,3,3,11,1,9,1
H557,30,17,12,3,2,13,4,9,0
H554,29,22,10,7,5,7,2,4,1
H555,26,12,7,5,0,14,4,8,2
H558,27,2,1,1,0,25,9,13,3
H559,30,21,14,5,2,9,2,6,1
E854,27,7,6,1,0,20,5,13,2
E855,27,11,5,5,1,16,6,8,2
E850,28,12,8,2,2,16,1,14,1
E851,28,11,11,0,0,17,3,13,1
E852,30,18,13,4,1,12,1,9,2
E853,31,20,13,4,3,11,1,8,2
R587,31,17,13,4,0,14,3,10,1
R586,31,9,4,5,0,22,8,11,3
R585,30,19,10,8,1,11,3,6,2
R584,25,7,6,1,0,18,5,13,0
R583,26,14,9,5,0,12,4,7,1
R582,31,10,7,2,1,21,7,13,1
R581,31,13,10,2,1,18,5,12,1
R580,31,22,13,8,1,9,1,7,1
R589,34,19,7,7,5,15,5,9,1
R588,31,7,2,3,2,24,10,14,0
D848,26,19,10,7,2,7,1,6,0
R638,30,3,2,1,0,27,10,15,2
R635,34,20,10,4,6,14,4,9,1
R634,26,15,7,6,2,11,3,8,0
R637,33,26,15,7,4,7,1,3,3
R636,34,29,16,7,6,5,1,3,1
R631,30,4,2,1,1,26,10,13,3
R630,31,14,8,4,2,17,4,11,2
R633,30,12,8,3,1,18,3,13,2
R632,29,11,6,4,1,18,3,14,1
C799,28,8,5,3,0,20,8,12,0
C797,26,6,4,2,0,20,6,14,0
D655,27,12,12,0,0,15,4,10,1
D654,27,9,5,4,0,18,8,10,0
D657,27,18,8,8,2,9,2,7,0
C796,27,13,8,5,0,14,5,8,1
D651,29,19,11,7,1,10,3,6,1
D650,28,19,9,6,4,9,0,8,1
D653,28,13,5,6,2,15,9,5,1
D652,25,9,7,2,0,16,5,11,0
D659,28,16,10,5,1,12,4,7,1
D658,27,5,3,2,0,22,9,12,1
K779,31,18,6,8,4,13,4,8,1
K778,27,12,10,2,0,15,7,8,0
K773,31,19,10,6,3,12,0,11,1
K772,28,7,5,0,2,21,8,10,3
K771,29,7,4,1,2,22,10,9,3
K777,27,3,2,1,0,24,9,13,2
K776,27,10,8,2,0,17,5,12,0
K775,27,8,6,2,0,19,7,10,2
K774,29,9,7,2,0,20,3,14,3
L659,32,24,13,8,3,8,1,5,2
L658,30,13,7,6,0,17,7,9,1
L655,32,17,14,1,2,15,4,9,2
L654,30,19,10,6,3,11,4,6,1
L657,28,10,3,7,0,18,6,9,3
L651,31,22,15,6,1,9,4,2,3
L650,30,10,7,3,0,20,4,14,2
L653,31,18,8,9,1,13,4,7,2
L652,29,11,7,3,1,18,5,12,1
H839,29,24,16,7,1,5,0,4,1
H838,31,21,14,7,0,10,1,9,0
H835,31,23,15,5,3,8,0,7,1
H834,26,5,3,2,0,21,6,13,2
H836,29,19,11,7,1,10,2,6,2
H831,29,11,8,1,2,18,7,10,1
H830,29,14,11,2,1,15,3,10,2
H833,24,6,4,2,0,18,5,12,1
H832,27,8,3,2,3,19,6,11,2
N806,32,13,5,5,3,19,8,9,2
N807,31,12,6,5,1,19,7,10,2
N804,32,7,4,3,0,25,6,16,3
N805,33,22,13,7,2,11,1,7,3
N802,33,23,13,7,3,10,2,6,2
N803,23,6,4,1,1,17,3,10,4
N800,30,18,10,6,2,12,2,8,2
N801,30,13,9,2,2,17,5,11,1
N808,29,16,10,6,0,13,2,10,1
N809,30,16,12,3,1,14,3,8,3
A758,27,19,10,7,2,8,2,4,2
A757,26,11,6,5,0,15,7,8,0
A756,29,13,8,2,3,16,6,8,2
A755,25,13,8,3,2,12,5,6,1
A754,27,13,9,3,1,14,4,10,0
A753,27,13,8,4,1,14,6,7,1
A752,25,14,7,5,2,11,3,7,1
A751,25,11,6,5,0,14,5,8,1
O649,27,8,5,3,0,19,3,14,2
O648,31,14,10,4,0,17,3,13,1
O643,28,10,9,1,0,18,5,13,0
O642,32,19,13,6,0,13,3,10,0
O641,30,12,6,4,2,18,7,8,3
O640,34,32,18,7,7,2,0,2,0
O647,31,15,6,6,3,16,3,10,3
O646,29,16,8,8,0,13,5,7,1
O645,28,12,5,5,2,16,6,9,1
O644,32,22,15,7,0,10,2,8,0
I744,30,17,9,5,3,13,4,8,1
I745,28,13,8,4,1,15,3,11,1
I746,27,15,12,2,1,12,2,9,1
I747,28,17,9,6,2,11,1,6,4
I740,26,10,7,3,0,16,5,11,0
I741,31,19,10,6,3,12,5,6,1
I742,31,21,11,6,4,10,3,6,1
I743,32,20,9,8,3,12,4,7,1
I749,29,25,13,11,1,4,1,2,1
H765,27,19,13,6,0,8,1,7,0
H764,29,17,13,3,1,12,3,7,2
H767,30,17,10,5,2,13,3,9,1
H766,29,19,9,8,2,10,5,4,1
H761,25,9,6,3,0,16,5,11,0
H762,28,9,5,3,1,19,6,12,1
A573,29,11,6,4,1,18,8,10,0
A571,27,10,6,3,1,17,5,10,2
A570,25,13,8,4,1,12,3,7,2
H769,28,12,11,1,0,16,4,11,1
H768,26,12,8,3,1,14,3,10,1
A575,27,12,7,5,0,15,6,8,1
A574,28,17,9,5,3,11,4,6,1
P581,28,6,5,1,0,22,6,13,3
P580,29,13,6,6,1,16,5,9,2
P583,30,15,8,4,3,15,4,7,4
P582,28,8,6,2,0,20,6,14,0
P585,28,11,5,5,1,17,5,9,3
P584,25,4,2,0,2,21,8,13,0
P587,29,14,11,3,0,15,3,11,1
P586,32,21,10,9,2,11,1,7,3
P589,31,24,13,9,2,7,3,4,0
P588,29,5,3,2,0,24,11,13,0
G678,32,17,12,4,1,15,3,8,4
G679,30,18,8,8,2,12,4,6,2
G676,32,21,13,4,4,11,3,6,2
G677,28,17,10,6,1,11,5,4,2
G674,29,19,13,3,3,10,1,7,2
G675,33,26,13,7,6,7,1,5,1
G672,28,13,10,2,1,15,2,11,2
G673,29,17,13,3,1,12,3,8,1
G670,29,11,9,1,1,18,6,10,2
G671,30,19,15,4,0,11,2,5,4
P769,30,14,11,3,0,16,6,9,1
P768,26,10,6,4,0,16,6,9,1
P765,25,14,9,5,0,11,3,7,1
P764,31,13,8,4,1,18,7,7,4
P767,28,14,11,3,0,14,6,7,1
P766,31,13,8,4,1,18,7,10,1
P761,26,12,6,5,1,14,2,10,2
P760,30,5,3,2,0,25,8,14,3
P763,31,11,6,4,1,20,6,13,1
P762,31,9,4,4,1,22,8,13,1
E629,31,27,17,6,4,4,0,3,1
E628,30,14,9,3,2,16,4,10,2
E627,30,20,9,9,2,10,3,7,0
E626,31,22,12,6,4,9,1,6,2
E625,28,20,13,5,2,8,2,5,1
E624,29,9,7,1,1,20,6,12,2
E623,30,21,13,5,3,9,2,5,2
E622,30,10,10,0,0,20,6,12,2
E621,25,6,3,2,1,19,7,10,2
E620,27,10,5,3,2,17,4,11,2
E579,27,15,10,5,0,12,2,9,1
M627,32,12,7,5,0,20,5,12,3
M626,30,14,11,2,1,16,2,13,1
M625,32,25,17,7,1,7,2,3,2
M624,32,23,14,7,2,9,1,5,3
M623,35,16,7,3,6,19,8,8,3
M622,32,17,11,5,1,15,2,10,3
M621,29,10,6,4,0,19,5,12,2
M620,28,7,5,2,0,21,7,14,0
E578,29,9,7,2,0,20,6,11,3
M629,31,13,11,1,1,18,6,10,2
M628,32,13,10,3,0,19,8,8,3
J845,27,22,11,11,0,5,1,3,1
F781,28,1,1,0,0,27,11,14,2
F780,31,17,11,4,2,14,4,8,2
F783,29,27,13,11,3,2,2,0,0
F782,28,4,4,0,0,24,9,14,1
F785,23,12,9,3,0,11,1,10,0
F784,28,16,9,6,1,12,3,8,1
F787,26,12,8,4,0,14,2,10,2
F786,32,24,15,4,5,8,2,5,1
F789,33,21,12,8,1,12,5,6,1
F788,30,19,15,3,1,11,1,7,3
F569,31,19,10,6,3,12,5,6,1
F568,29,12,6,2,4,17,4,9,4
F565,29,20,11,8,1,9,1,6,2
F564,27,4,2,2,0,23,12,11,0
F567,26,7,5,2,0,19,7,11,1
F566,25,3,3,0,0,22,9,13,0
F561,26,6,3,3,0,20,8,9,3
F560,28,13,7,4,2,15,5,9,1
F562,31,24,14,7,3,7,0,5,2
B699,28,19,13,5,1,9,2,6,1
B698,30,16,12,3,1,14,3,9,2
B696,25,14,7,7,0,11,5,6,0
B695,30,16,13,2,1,14,5,8,1
B693,25,13,8,5,0,12,3,9,0
B692,26,18,12,6,0,8,1,7,0
B690,27,11,8,3,0,16,4,12,0
I539,28,13,11,2,0,15,4,9,2
I538,26,10,7,3,0,16,5,10,1
I537,29,5,4,1,0,24,8,12,4
I536,27,19,11,5,3,8,0,7,1
I535,29,15,11,4,0,14,5,9,0
I534,29,17,9,8,0,12,5,6,1
I533,27,12,8,2,2,15,2,11,2
I531,26,13,7,6,0,13,4,9,0
I530,30,15,11,3,1,15,4,10,1
Q799,32,1,1,0,0,31,13,15,3
Q798,32,16,9,5,2,16,7,7,2
Q793,33,20,15,4,1,13,3,7,3
Q792,30,17,7,7,3,13,5,7,1
Q791,30,18,9,7,2,12,2,8,2
Q790,31,17,14,3,0,14,3,8,3
Q797,29,2,0,2,0,27,12,15,0
Q796,31,8,7,1,0,23,8,11,4
Q795,26,9,5,3,1,17,5,11,1
Q794,31,13,10,2,1,18,7,8,3
Q537,31,10,5,3,2,21,6,13,2
Q536,31,23,11,8,4,8,3,3,2
Q535,33,19,11,6,2,14,5,9,0
Q534,28,18,11,7,0,10,2,7,1
Q533,32,23,13,10,0,9,3,6,0
Q532,30,2,1,0,1,28,10,17,1
Q531,30,7,5,1,1,23,9,12,2
Q530,32,7,6,1,0,25,10,12,3
Q539,33,24,17,5,2,9,1,6,2
Q538,31,16,8,5,3,15,4,10,1
J634,26,4,3,0,1,22,6,13,3
J632,31,14,8,5,1,17,5,9,3
L826,30,15,8,6,1,15,3,9,3
L827,30,19,14,4,1,11,3,6,2
L824,31,14,11,1,2,17,7,9,1
L825,33,27,12,11,4,6,2,2,2
L822,33,22,12,5,5,11,1,10,0
L823,27,20,12,8,0,7,1,6,0
L820,26,4,3,1,0,22,9,13,0
L821,30,11,9,1,1,19,6,11,2
L828,32,25,9,13,3,7,4,3,0
L829,31,21,10,8,3,10,4,4,2
R839,31,13,11,1,1,18,5,10,3
R838,31,19,11,7,1,12,3,9,0
R836,31,19,10,6,3,12,2,9,1
R835,34,19,10,4,5,15,4,9,2
R834,28,20,10,7,3,8,2,5,1
R833,31,12,5,5,2,19,6,11,2
R832,28,11,5,5,1,17,5,10,2
R831,32,13,10,2,1,19,7,9,3
R830,32,21,18,3,0,11,1,8,2
H538,29,15,6,6,3,14,6,6,2
H539,29,21,13,7,1,8,1,4,3
D801,27,12,8,3,1,15,7,7,1
H530,29,11,6,3,2,18,7,10,1
H531,28,17,7,10,0,11,3,6,2
H533,28,13,6,4,3,15,4,9,2
H534,28,5,5,0,0,23,8,15,0
H535,29,24,11,10,3,5,0,5,0
H536,31,23,13,6,4,8,1,5,2
H537,29,23,11,9,3,6,1,5,0
D803,27,5,5,0,0,22,5,16,1
D804,26,7,5,2,0,19,5,13,1
D805,31,20,11,7,2,11,6,4,1
B782,28,13,10,3,0,15,3,12,0
R659,31,10,6,3,1,21,7,11,3
R658,32,14,7,5,2,18,4,12,2
R653,32,21,11,7,3,11,3,7,1
R652,32,10,4,2,4,22,9,11,2
R651,34,29,15,8,6,5,1,3,1
R650,31,25,13,10,2,6,0,5,1
R657,29,10,7,3,0,19,4,15,0
R655,31,19,14,4,1,12,3,8,1
R654,30,14,7,6,1,16,6,9,1
D633,25,10,4,4,2,15,5,10,0
D632,27,15,7,8,0,12,2,10,0
D631,26,10,6,4,0,16,6,10,0
D637,31,19,14,3,2,12,2,7,3
D636,30,21,12,6,3,9,3,5,1
D635,27,16,10,6,0,11,4,6,1
D634,24,6,3,3,0,18,6,12,0
D639,27,21,11,8,2,6,1,5,0
K751,27,18,10,7,1,9,2,7,0
K750,28,11,8,3,0,17,5,12,0
K753,29,17,8,6,3,12,4,8,0
K752,29,18,8,8,2,11,3,7,1
K755,28,11,8,3,0,17,6,8,3
K754,30,22,12,6,4,8,2,5,1
K757,28,14,8,5,1,14,4,9,1
K756,31,6,2,3,1,25,11,12,2
K759,27,1,1,0,0,26,5,19,2
K758,27,11,7,3,1,16,5,10,1
L639,31,20,10,7,3,11,2,8,1
L638,30,12,7,2,3,18,5,12,1
L633,27,13,10,3,0,14,1,12,1
L632,33,20,7,8,5,13,2,10,1
L631,28,13,6,4,3,15,4,6,5
L630,26,9,5,4,0,17,5,12,0
L637,33,22,13,6,3,11,2,8,1
L636,34,30,16,8,6,4,2,2,0
L635,30,7,4,2,1,23,10,11,2
L634,28,8,5,2,1,20,7,12,1
H853,30,25,14,10,1,5,1,2,2
H852,29,19,11,5,3,10,3,5,2
H851,27,9,9,0,0,18,5,12,1
H850,25,10,4,5,1,15,4,10,1
H855,27,7,6,1,0,20,5,14,1
H854,26,13,4,6,3,13,4,9,0
B734,24,7,5,2,0,17,3,13,1
B736,26,23,9,13,1,3,2,1,0
B737,31,20,12,5,3,11,3,6,2
B730,26,5,4,1,0,21,8,12,1
B731,30,16,9,3,4,14,4,8,2
B732,26,8,5,3,0,18,7,11,0
B733,23,6,5,1,0,17,4,13,0
B738,28,17,11,6,0,11,4,6,1
O661,29,20,11,8,1,9,3,4,2
O660,33,22,13,6,3,11,4,5,2
O663,31,11,6,3,2,20,6,11,3
O662,30,22,15,7,0,8,1,3,4
O665,32,11,6,4,1,21,6,12,3
O664,27,7,4,3,0,20,5,13,2
O667,31,14,8,4,2,17,6,11,0
O666,32,23,16,6,1,9,3,3,3
O669,32,14,10,2,2,18,3,13,2
O668,32,19,11,2,6,13,4,8,1
I762,25,9,6,2,1,16,5,11,0
I761,25,16,10,5,1,9,1,7,1
I766,30,14,9,5,0,16,7,9,0
I767,30,12,4,5,3,18,8,8,2
I764,28,19,13,5,1,9,2,5,2
I765,26,17,12,5,0,9,0,9,0
I768,26,10,6,3,1,16,5,11,0
I769,33,23,14,5,4,10,3,6,1
J685,28,13,8,4,1,15,2,11,2
J686,27,7,3,3,1,20,8,11,1
J687,26,15,8,6,1,11,4,7,0
J680,28,16,10,4,2,12,2,10,0
J681,26,12,9,3,0,14,3,9,2
J682,24,8,4,3,1,16,6,10,0
J683,30,14,10,3,1,16,1,12,3
J688,25,4,3,1,0,21,5,14,2
H703,27,13,11,1,1,14,1,12,1
J507,28,13,7,6,0,15,4,11,0
H701,27,9,9,0,0,18,7,10,1
H700,28,5,2,3,0,23,9,12,2
H707,29,14,8,4,2,15,4,10,1
H705,27,2,1,1,0,25,9,16,0
H704,29,17,8,7,2,12,4,7,1
H708,32,17,11,3,3,15,4,9,2
F534,28,4,3,0,1,24,10,13,1
F535,30,23,13,7,3,7,1,6,0
P569,35,22,14,6,2,13,5,6,2
P568,30,16,8,5,3,14,3,9,2
P567,28,5,3,2,0,23,8,15,0
P566,26,5,4,1,0,21,7,14,0
P565,30,12,5,5,2,18,5,10,3
P564,30,10,6,4,0,20,5,12,3
P563,28,9,7,2,0,19,8,11,0
P562,33,19,15,3,1,14,3,9,2
P561,28,10,6,3,1,18,6,11,1
P560,27,13,8,5,0,14,3,10,1
A775,28,10,5,4,1,18,6,10,2
A774,24,11,6,3,2,13,3,10,0
A777,27,13,7,6,0,14,4,10,0
A776,27,9,4,4,1,18,7,11,0
A771,28,12,8,3,1,16,6,9,1
A773,25,13,7,5,1,12,2,7,3
A772,26,11,6,4,1,15,7,7,1
A779,27,15,8,4,3,12,2,9,1
A778,27,11,8,3,0,16,8,8,0
P709,29,15,7,4,4,14,3,10,1
P708,33,26,15,7,4,7,0,3,4
F538,26,7,4,3,0,19,9,10,0
P702,31,14,10,3,1,17,5,9,3
P701,32,20,12,6,2,12,3,7,2
J508,28,6,4,2,0,22,7,13,2
P707,32,12,7,3,2,20,4,14,2
P706,26,11,6,5,0,15,5,9,1
P705,24,10,7,3,0,14,2,11,1
P704,32,9,6,2,1,23,7,14,2
C782,27,8,7,1,0,19,7,12,0
A550,23,7,4,3,0,16,6,7,3
A553,24,3,2,1,0,21,7,13,1
C781,25,10,6,4,0,15,4,10,1
A555,29,15,6,6,3,14,3,10,1
A802,29,22,11,8,3,7,3,4,0
C784,24,10,6,4,0,14,4,10,0
A800,25,9,6,2,1,16,3,11,2
A559,32,30,15,11,4,2,0,1,1
A558,25,6,2,4,0,19,6,11,2
C788,31,26,16,8,2,5,1,2,2
C789,29,21,10,8,3,8,4,4,0
A809,28,10,2,5,3,18,10,7,1
E605,29,17,8,8,1,12,6,5,1
E604,30,10,8,1,1,20,7,11,2
E607,32,24,11,9,4,8,1,4,3
E606,30,13,11,0,2,17,5,10,2
E600,27,15,9,6,0,12,2,8,2
E603,31,17,12,2,3,14,4,7,3
E602,30,19,12,6,1,11,1,8,2
E608,28,0,0,0,0,28,10,15,3
D825,31,15,10,3,2,16,5,9,2
N774,29,10,7,2,1,19,5,13,1
N775,30,15,8,7,0,15,6,6,3
N776,30,10,6,4,0,20,6,14,0
N777,29,6,4,2,0,23,8,15,0
N770,12,5,2,2,1,7,1,6,0
N771,31,9,7,1,1,22,7,12,3
N772,29,12,6,1,5,17,6,8,3
N773,29,8,6,2,0,21,5,13,3
B851,26,6,5,1,0,20,9,11,0
B850,24,4,4,0,0,20,6,14,0
B853,27,22,13,9,0,5,2,3,0
B852,27,11,7,4,0,16,5,10,1
N778,33,16,14,1,1,17,8,9,0
N779,32,17,7,7,3,15,6,5,4
M608,24,7,4,3,0,17,5,11,1
M605,30,9,6,3,0,21,8,12,1
M604,32,16,10,2,4,16,5,8,3
M607,32,25,13,7,5,7,1,3,3
M606,32,15,6,6,3,17,7,8,2
M601,31,15,8,5,2,16,3,10,3
M600,30,18,9,6,3,12,2,7,3
M603,32,27,16,8,3,5,0,4,1
M602,33,23,13,5,5,10,1,7,2
F769,29,15,10,4,1,14,6,7,1
F768,30,20,11,9,0,10,4,6,0
F767,29,17,10,5,2,12,2,8,2
F766,30,19,11,6,2,11,2,7,2
F765,24,7,4,3,0,17,7,10,0
F764,30,16,12,3,1,14,5,8,1
F762,28,16,8,5,3,12,4,6,2
F761,28,7,3,4,0,21,7,13,1
B509,26,10,7,2,1,16,3,12,1
B508,26,10,7,3,0,16,4,12,0
B506,28,8,6,2,0,20,4,16,0
B504,31,17,10,3,4,14,5,8,1
B503,25,7,6,1,0,18,6,11,1
B502,22,4,3,0,1,18,8,10,0
J514,26,5,2,3,0,21,7,13,1
J515,30,18,13,2,3,12,3,7,2
J516,26,13,9,3,1,13,2,9,2
J517,25,1,1,0,0,24,11,13,0
J510,27,15,10,3,2,12,1,11,0
J511,33,27,15,8,4,6,1,3,2
J512,31,18,13,4,1,13,5,6,2
J513,25,15,10,4,1,10,1,8,1
J518,31,14,8,3,3,17,7,7,3
J519,32,13,7,3,3,19,5,11,3
F509,27,7,6,1,0,20,7,13,0
F508,30,15,8,6,1,15,2,10,3
F503,28,12,8,4,0,16,5,10,1
F502,29,8,5,1,2,21,9,11,1
F507,26,5,3,1,1,21,10,11,0
F506,30,22,11,8,3,8,2,5,1
F505,28,17,11,5,1,11,2,9,0
F504,31,21,17,2,2,10,1,7,2
I515,28,12,10,1,1,16,6,8,2
I514,27,1,0,1,0,26,10,16,0
I517,25,4,2,2,0,21,11,8,2
I516,26,15,8,6,1,11,4,6,1
I511,29,20,13,5,2,9,2,5,2
I510,29,8,3,4,1,21,8,12,1
I513,26,14,10,3,1,12,2,8,2
I512,27,10,7,2,1,17,8,9,0
I519,28,19,10,8,1,9,0,7,2
I518,28,14,12,1,1,14,5,8,1
J814,26,9,6,3,0,17,5,12,0
Q519,31,11,7,4,0,20,6,12,2
Q518,31,15,14,1,0,16,3,10,3
Q515,32,18,17,1,0,14,3,9,2
Q514,33,11,6,3,2,22,3,15,4
Q517,29,11,8,3,0,18,6,11,1
Q516,33,13,9,2,2,20,5,14,1
Q511,34,23,14,7,2,11,3,4,4
Q510,29,11,7,3,1,18,5,11,2
Q513,30,14,8,6,0,16,6,8,2
Q512,31,10,7,2,1,21,10,7,4
N549,32,18,14,4,0,14,5,7,2
N548,30,17,9,6,2,13,3,9,1
N547,32,16,11,5,0,16,3,10,3
N546,31,11,9,2,0,20,6,10,4
N545,26,6,4,2,0,20,8,10,2
N544,30,13,8,5,0,17,5,12,0
N543,31,8,4,2,2,23,5,15,3
N542,25,6,4,1,1,19,8,10,1
N541,31,11,4,5,2,20,8,12,0
N540,28,12,8,4,0,16,4,10,2
R815,29,7,4,2,1,22,9,12,1
R814,29,13,7,6,0,16,4,8,4
R817,33,24,18,6,0,9,3,6,0
R816,29,9,8,1,0,20,5,15,0
R811,32,12,9,2,1,20,5,14,1
R810,34,25,15,6,4,9,3,3,3
R813,30,7,5,1,1,23,8,14,1
R812,27,4,3,1,0,23,9,13,1
R819,32,19,7,10,2,13,7,5,1
R818,32,14,10,3,1,18,6,9,3
H516,26,11,7,3,1,15,5,9,1
H517,25,3,2,1,0,22,9,12,1
H514,28,4,2,2,0,24,8,16,0
H515,28,9,8,1,0,19,8,9,2
H512,29,18,12,4,2,11,3,6,2
H513,28,16,9,4,3,12,2,8,2
H510,26,16,9,6,1,10,2,7,1
H511,28,25,14,11,0,3,1,1,1
H518,30,19,13,3,3,11,4,5,2
H519,27,20,11,6,3,7,0,7,0
E818,30,16,10,5,1,14,4,8,2
E819,25,13,7,5,1,12,5,7,0
E810,30,19,12,5,2,11,4,6,1
E811,33,25,12,9,4,8,2,4,2
E812,26,17,9,8,0,9,3,5,1
E813,28,10,4,6,0,18,7,9,2
E814,29,10,7,1,2,19,3,15,1
E815,27,14,8,6,0,13,3,8,2
E816,30,18,11,6,1,12,1,10,1
E817,30,23,18,4,1,7,2,5,0
R671,32,24,16,6,2,8,1,5,2
R670,32,25,16,5,4,7,1,5,1
R673,32,20,15,3,2,12,2,8,2
R672,33,28,15,11,2,5,0,3,2
R675,32,10,7,1,2,22,7,11,4
R674,34,26,16,6,4,8,1,6,1
R677,31,7,2,4,1,24,11,11,2
R676,33,23,17,2,4,10,0,8,2
R679,31,10,5,3,2,21,8,13,0
R678,31,9,6,2,1,22,7,12,3
D619,27,2,2,0,0,25,10,14,1
D611,27,11,7,4,0,16,6,9,1
D610,27,8,5,3,0,19,6,10,3
D613,26,6,6,0,0,20,13,7,0
D612,25,12,5,6,1,13,5,7,1
D615,30,21,11,7,3,9,0,6,3
D614,18,4,4,0,0,14,3,10,1
D617,27,10,6,3,1,17,6,10,1
D616,26,6,5,1,0,20,5,12,3
L611,31,13,7,5,1,18,5,12,1
L610,31,15,6,7,2,16,6,8,2
L613,31,18,13,3,2,13,3,8,2
L612,28,12,6,6,0,16,7,9,0
L615,30,21,10,9,2,9,1,6,2
L614,28,18,11,6,1,10,1,7,2
L617,33,18,11,4,3,15,3,10,2
L616,33,25,14,10,1,8,1,6,1
L619,31,9,4,2,3,22,7,13,2
B712,27,7,2,5,0,20,10,9,1
B713,26,20,12,8,0,6,2,4,0
B711,23,7,4,3,0,16,6,9,1
B716,27,12,8,4,0,15,4,11,0
B717,27,14,12,2,0,13,3,9,1
B714,28,16,9,6,1,12,3,8,1
B715,29,7,6,1,0,22,10,10,2
B719,26,16,11,5,0,10,2,8,0
E529,28,21,11,9,1,7,0,6,1
O689,27,9,4,5,0,18,8,9,1
O688,30,23,11,9,3,7,1,4,2
O687,32,28,13,11,4,4,0,4,0
O686,31,16,10,6,0,15,3,12,0
O685,31,8,5,3,0,23,3,15,5
O683,36,27,11,12,4,9,1,7,1
O682,31,21,12,7,2,10,2,6,2
O681,27,13,7,6,0,14,5,9,0
O680,29,20,12,7,1,9,2,7,0
I708,28,18,12,3,3,10,2,7,1
I700,30,10,3,5,2,20,9,10,1
I701,26,12,12,0,0,14,4,9,1
I702,25,11,6,4,1,14,7,7,0
I703,30,16,8,4,4,14,3,9,2
I704,30,21,9,10,2,9,4,4,1
I705,23,2,2,0,0,21,8,13,0
I707,28,12,8,3,1,16,3,10,3
P545,28,12,8,3,1,16,3,12,1
H728,27,22,11,9,2,5,2,3,0
P547,30,14,8,6,0,16,6,10,0
P546,30,10,7,2,1,20,7,11,2
P541,30,15,10,5,0,15,4,10,1
P540,30,11,6,4,1,19,7,10,2
P543,28,1,1,0,0,27,9,18,0
P542,26,2,1,0,1,24,9,14,1
H721,30,24,15,5,4,6,1,3,2
H720,31,17,11,3,3,14,5,6,3
H723,27,12,8,4,0,15,6,8,1
H722,29,20,13,5,2,9,2,5,2
H725,32,23,14,5,4,9,2,6,1
P548,29,4,2,1,1,25,5,16,4
H727,28,12,9,3,0,16,5,10,1
H726,27,12,6,6,0,15,7,7,1
C510,26,18,10,8,0,8,3,5,0
A713,24,4,3,1,0,20,7,13,0
A712,28,4,0,3,1,24,11,12,1
A711,28,15,9,5,1,13,3,9,1
A717,27,9,6,3,0,18,7,10,1
A716,25,5,3,2,0,20,8,12,0
A715,27,7,4,3,0,20,10,10,0
A714,27,14,9,5,0,13,5,7,1
A719,29,15,9,3,3,14,3,9,2
P721,31,14,12,1,1,17,4,9,4
P720,34,32,20,9,3,2,0,2,0
P723,33,27,14,7,6,6,2,4,0
P722,32,19,13,1,5,13,2,9,2
P725,32,15,10,3,2,17,8,7,2
P724,34,19,9,7,3,15,3,9,3
P727,29,14,6,6,2,15,5,9,1
P726,31,11,9,1,1,20,7,12,1
P729,33,19,13,3,3,14,5,8,1
P728,28,13,7,4,2,15,5,10,0
A829,31,25,12,7,6,6,1,3,2
A828,25,11,6,5,0,14,3,10,1
A825,32,24,15,6,3,8,1,6,1
A824,26,11,8,2,1,15,6,9,0
A827,29,16,13,2,1,13,4,7,2
A826,29,19,8,6,5,10,2,7,1
A821,29,23,12,9,2,6,1,5,0
A820,26,13,7,5,1,13,4,8,1
A822,29,14,9,4,1,15,4,8,3
G764,29,11,6,4,1,18,7,8,3
G765,27,12,8,4,0,15,4,11,0
G766,34,16,12,3,1,18,5,11,2
G767,29,15,8,6,1,14,6,7,1
G761,26,6,2,4,0,20,9,9,2
G762,26,4,3,1,0,22,9,13,0
G768,26,5,4,1,0,21,9,11,1
G769,31,17,10,5,2,14,6,5,3
E663,31,16,6,8,2,15,6,7,2
E662,33,24,17,5,2,9,1,6,2
E661,28,19,11,7,1,9,2,5,2
E660,28,15,12,3,0,13,4,8,1
E667,31,10,4,5,1,21,6,11,4
E666,30,14,11,3,0,16,6,8,2
E665,29,12,6,5,1,17,5,9,3
E664,27,6,4,2,0,21,8,13,0
E669,30,15,7,6,2,15,5,9,1
E668,31,21,11,8,2,10,5,3,2
H729,28,7,7,0,0,21,9,11,1
P544,31,19,12,6,1,12,2,10,0
N752,30,14,8,4,2,16,4,12,0
N753,30,14,7,4,3,16,6,7,3
N750,31,17,10,7,0,14,4,10,0
N751,26,14,7,7,0,12,4,7,1
N756,28,11,6,5,0,17,7,10,0
N757,30,15,9,3,3,15,4,10,1
N754,31,22,12,6,4,9,2,5,2
N755,28,9,5,3,1,19,5,13,1
N758,31,14,9,4,1,17,3,10,4
N759,25,11,9,2,0,14,3,11,0
M669,32,17,9,4,4,15,3,10,2
M668,31,21,13,4,4,10,2,6,2
M663,31,21,11,7,3,10,3,6,1
M662,32,18,13,5,0,14,6,4,4
M661,28,14,11,3,0,14,4,8,2
M660,32,23,15,5,3,9,2,5,2
M667,29,10,5,4,1,19,7,11,1
M666,34,33,20,10,3,1,1,0,0
M665,32,4,4,0,0,28,7,18,3
M664,26,10,5,5,0,16,4,11,1
P549,33,25,15,7,3,8,3,4,1
H724,27,17,11,5,1,10,1,7,2
F745,29,7,5,2,0,22,6,14,2
F744,28,16,10,6,0,12,3,8,1
F747,32,19,9,7,3,13,2,9,2
F746,27,11,8,2,1,16,7,8,1
F741,29,7,6,1,0,22,8,11,3
F740,28,18,10,6,2,10,0,9,1
F743,27,21,11,9,1,6,2,3,1
F742,30,14,10,3,1,16,6,9,1
F749,29,15,10,5,0,14,4,7,3
F521,28,17,12,3,2,11,3,7,1
J533,31,22,12,8,2,9,1,7,1
J530,28,13,12,1,0,15,3,11,1
J531,28,12,5,6,1,16,6,9,1
J536,28,7,5,2,0,21,8,9,4
J537,26,8,6,2,0,18,7,11,0
J534,31,22,12,8,2,9,2,6,1
J535,26,11,8,3,0,15,4,9,2
F529,27,13,8,5,0,14,4,9,1
F528,28,14,8,5,1,14,4,9,1
J538,26,4,3,1,0,22,10,12,0
J539,29,13,8,4,1,16,9,6,1
I573,30,21,11,7,3,9,4,4,1
I572,26,13,8,5,0,13,4,9,0
I571,28,13,7,5,1,15,3,11,1
I570,28,16,10,6,0,12,3,8,1
I577,32,27,14,8,5,5,1,2,2
I576,28,18,10,7,1,10,2,5,3
I575,27,11,6,4,1,16,6,9,1
I574,30,19,12,6,1,11,3,7,1
I579,24,4,3,1,0,20,7,13,0
I578,29,12,8,3,1,17,8,9,0
Q759,30,19,12,6,1,11,1,9,1
Q758,28,6,4,0,2,22,9,11,2
Q757,28,18,9,7,2,10,3,6,1
Q756,30,8,5,2,1,22,8,13,1
Q755,31,18,10,5,3,13,4,6,3
Q754,31,24,15,7,2,7,2,4,1
Q753,29,11,5,4,2,18,8,8,2
Q752,28,9,5,4,0,19,8,10,1
Q751,28,9,4,5,0,19,7,9,3
Q750,32,14,7,5,2,18,6,11,1
B527,29,21,11,7,3,8,3,5,0
B526,27,14,9,5,0,13,4,7,2
B521,29,17,13,2,2,12,3,7,2
B520,28,15,13,1,1,13,0,13,0
B523,27,11,8,3,0,16,3,13,0
B529,30,21,11,7,3,9,1,6,2
B528,29,25,12,12,1,4,0,4,0
Q579,27,10,5,5,0,17,7,10,0
Q578,30,15,10,4,1,15,5,9,1
Q573,31,12,7,3,2,19,9,8,2
Q572,31,22,14,7,1,9,2,6,1
Q571,27,13,6,7,0,14,5,8,1
Q570,31,18,11,6,1,13,3,9,1
Q577,33,27,13,8,6,6,3,2,1
Q576,33,27,13,11,3,6,0,3,3
Q575,31,16,11,3,2,15,3,9,3
Q574,33,20,11,6,3,13,4,8,1
K654,28,17,11,5,1,11,3,8,0
K655,30,22,14,8,0,8,2,4,2
K657,26,10,5,3,2,16,4,11,1
K650,31,19,9,7,3,12,2,8,2
K651,30,18,16,1,1,12,3,8,1
K652,30,12,7,4,1,18,5,11,2
K653,28,15,8,7,0,13,4,8,1
K658,28,18,10,7,1,10,3,6,1
K659,29,19,8,10,1,10,4,5,1
N565,29,16,9,5,2,13,2,11,0
N564,31,14,5,7,2,17,6,7,4
N567,27,8,5,3,0,19,9,9,1
N566,29,2,2,0,0,27,11,16,0
N561,29,20,12,5,3,9,0,8,1
N560,31,12,6,4,2,19,2,14,3
N563,29,8,5,3,0,21,7,14,0
N562,33,26,15,8,3,7,2,4,1
N569,33,26,18,5,3,7,0,5,2
N568,32,25,11,10,4,7,3,2,2
N693,29,13,7,4,2,16,2,13,1
N692,30,19,12,7,0,11,3,7,1
N690,29,9,7,1,1,20,5,11,4
N695,30,16,14,2,0,14,4,8,2
N694,29,3,2,0,1,26,6,17,3
N699,32,20,12,8,0,12,7,5,0
N698,30,18,14,4,0,12,4,7,1
R699,30,11,9,2,0,19,7,11,1
R698,33,15,11,2,2,18,7,10,1
R697,29,10,6,3,1,19,5,13,1
R695,34,24,16,3,5,10,1,7,2
R694,28,19,9,9,1,9,2,5,2
R693,34,18,8,5,5,16,3,12,1
R692,30,7,4,2,1,23,9,13,1
R691,27,11,5,6,0,16,4,9,3
R690,29,4,2,2,0,25,11,14,0
E836,28,10,7,3,0,18,5,12,1
E834,28,6,2,2,2,22,8,12,2
E835,29,11,8,2,1,18,3,12,3
E832,25,2,1,0,1,23,9,13,1
E833,25,11,6,4,1,14,3,10,1
E830,30,19,11,5,3,11,2,8,1
E831,31,16,9,4,3,15,4,9,2
E838,26,10,5,4,1,16,5,11,0
E839,31,17,10,5,2,14,4,7,3
K829,29,25,12,10,3,4,1,2,1
K828,30,13,8,4,1,17,5,12,0
K827,29,17,11,6,0,12,7,5,0
K826,28,16,9,5,2,12,2,10,0
K825,29,19,13,6,0,10,3,7,0
K824,27,18,12,5,1,9,2,6,1
K823,27,14,10,4,0,13,2,9,2
K822,30,22,13,7,2,8,2,6,0
K821,28,13,9,3,1,15,5,8,2
K820,26,9,5,2,2,17,7,10,0
K795,24,2,1,1,0,22,9,13,0
K794,29,21,16,4,1,8,2,5,1
K797,26,11,8,3,0,15,3,12,0
K796,32,15,12,2,1,17,4,9,4
K791,27,12,7,5,0,15,4,11,0
K790,28,21,13,7,1,7,2,3,2
K793,33,27,16,7,4,6,1,3,2
K792,29,17,10,6,1,12,3,8,1
K799,28,12,7,5,0,16,6,8,2
K798,30,19,13,4,2,11,2,8,1
B778,27,13,7,6,0,14,9,5,0
B779,30,24,15,8,1,6,1,5,0
B771,27,8,7,1,0,19,8,10,1
B772,27,12,9,2,1,15,3,11,1
B773,26,8,5,3,0,18,7,11,0
B774,22,5,4,1,0,17,3,13,1
B775,28,14,9,3,2,14,5,9,0
B776,27,12,8,4,0,15,5,10,0
B777,28,13,7,6,0,15,4,11,0
I726,27,11,10,1,0,16,6,10,0
I727,30,23,11,9,3,7,1,4,2
I724,26,15,8,6,1,11,3,7,1
I725,27,15,9,4,2,12,3,6,3
I722,29,26,14,7,5,3,0,2,1
I723,29,17,11,5,1,12,4,7,1
I720,30,14,9,3,2,16,7,7,2
I721,29,19,13,3,3,10,3,6,1
I728,27,17,7,10,0,10,6,4,0
I729,28,9,7,1,1,19,7,11,1
P523,29,17,7,9,1,12,3,6,3
P522,34,30,12,13,5,4,0,4,0
P521,30,17,14,2,1,13,3,6,4
P520,30,18,10,6,2,12,3,7,2
P527,32,20,12,4,4,12,4,6,2
P526,31,19,9,9,1,12,4,7,1
P524,31,8,3,4,1,23,10,12,1
P529,32,13,9,4,0,19,5,11,3
P528,34,21,12,5,4,13,2,10,1
A738,30,25,14,9,2,5,1,2,2
A731,27,10,7,2,1,17,8,8,1
A730,27,9,1,5,3,18,8,7,3
A732,27,17,8,4,5,10,2,8,0
A734,23,0,0,0,0,23,6,15,2
A737,28,17,12,5,0,11,4,6,1
A736,26,20,8,8,4,6,2,4,0
A595,27,13,10,2,1,14,6,8,0
A594,26,11,8,2,1,15,4,10,1
A597,29,19,14,4,1,10,2,8,0
A596,27,4,3,1,0,23,10,12,1
A590,26,8,7,1,0,18,6,12,0
A593,24,5,4,0,1,19,6,11,2
A592,28,12,6,4,2,16,6,7,3
A599,28,21,11,9,1,7,1,5,1
A598,24,7,5,2,0,17,4,12,1
A849,29,15,12,3,0,14,4,8,2
A848,25,6,3,3,0,19,8,10,1
A843,27,12,9,3,0,15,5,9,1
A842,28,18,8,7,3,10,1,8,1
A841,27,16,7,8,1,11,5,6,0
A840,27,16,12,4,0,11,3,8,0
A847,25,9,6,2,1,16,7,8,1
A846,29,8,6,1,1,21,9,10,2
A845,26,8,4,4,0,18,7,10,1
A844,27,24,13,10,1,3,0,2,1
G742,29,10,8,2,0,19,7,11,1
G743,32,19,9,6,4,13,4,7,2
G740,30,14,9,3,2,16,3,10,3
G741,28,8,5,3,0,20,7,12,1
G746,30,18,15,2,1,12,1,8,3
G747,29,14,6,7,1,15,4,8,3
G744,28,17,10,7,0,11,3,7,1
G745,30,12,8,4,0,18,7,10,1
G749,33,26,13,9,4,7,0,5,2
E648,26,7,2,4,1,19,7,11,1
E641,28,11,6,3,2,17,5,9,3
E640,30,21,14,5,2,9,0,6,3
E643,30,15,10,4,1,15,3,12,0
E642,28,22,12,9,1,6,1,4,1
E645,24,10,6,4,0,14,4,9,1
E644,27,6,4,1,1,21,7,14,0
E647,27,22,11,10,1,5,1,1,3
N738,34,25,15,5,5,9,3,5,1
N739,31,15,6,9,0,16,7,7,2
N730,30,7,3,2,2,23,10,11,2
N731,31,27,18,7,2,4,0,3,1
N732,31,19,12,5,2,12,2,9,1
N733,31,22,11,7,4,9,1,7,1
N734,29,13,7,5,1,16,2,12,2
N735,29,12,9,3,0,17,2,14,1
N736,26,12,7,5,0,14,6,8,0
N737,32,19,13,4,2,13,4,6,3
M641,31,14,5,8,1,17,7,7,3
M640,30,18,14,4,0,12,4,6,2
M643,26,15,10,5,0,11,2,8,1
M642,30,15,8,7,0,15,5,9,1
M645,29,13,10,3,0,16,2,12,2
M644,29,14,11,3,0,15,4,11,0
M647,31,6,5,1,0,25,8,15,2
M646,30,14,8,5,1,16,3,10,3
M649,28,6,4,2,0,22,5,15,2
M648,30,15,9,5,1,15,5,10,0
F723,30,13,9,3,1,17,4,10,3
F722,28,19,14,4,1,9,1,7,1
F721,32,26,15,7,4,6,1,5,0
F720,30,20,14,5,1,10,3,4,3
F727,27,15,8,5,2,12,4,7,1
F726,29,9,6,1,2,20,7,12,1
F725,28,14,9,5,0,14,6,7,1
F724,26,7,4,2,1,19,7,10,2
F729,30,19,10,5,4,11,4,6,1
F728,29,12,7,5,0,17,6,9,2
L528,30,12,7,5,0,18,7,10,1
J558,27,12,7,4,1,15,5,9,1
J559,29,22,14,7,1,7,3,3,1
R736,27,16,8,8,0,11,4,6,1
R737,31,17,12,4,1,14,4,7,3
R730,29,11,5,5,1,18,7,10,1
R731,32,24,16,6,2,8,3,3,2
R732,30,9,6,2,1,21,8,11,2
R733,26,6,6,0,0,20,6,14,0
J550,24,8,4,4,0,16,6,9,1
J551,31,16,10,3,3,15,5,7,3
J552,24,7,5,2,0,17,5,12,0
J553,26,8,6,2,0,18,5,13,0
J554,28,18,13,4,1,10,3,6,1
J555,26,10,6,4,0,16,4,9,3
J556,29,13,8,4,1,16,6,9,1
J557,26,9,9,0,0,17,4,12,1
Q775,31,20,11,6,3,11,2,8,1
Q774,29,12,5,4,3,17,6,10,1
Q777,29,6,5,1,0,23,8,15,0
Q776,30,15,8,7,0,15,4,10,1
Q771,32,19,13,5,1,13,2,8,3
Q770,26,8,5,3,0,18,7,11,0
Q773,28,14,7,6,1,14,2,10,2
Q772,31,23,13,7,3,8,0,6,2
I551,28,10,10,0,0,18,6,10,2
I550,24,3,2,1,0,21,10,11,0
I553,27,12,7,5,0,15,5,9,1
I552,27,2,0,2,0,25,11,12,2
Q779,33,20,13,5,2,13,3,8,2
Q778,32,13,11,2,0,19,9,10,0
I557,28,12,7,3,2,16,4,10,2
I556,27,17,11,6,0,10,3,6,1
O614,28,13,10,3,0,15,1,14,0
O615,32,18,10,6,2,14,5,7,2
B543,25,7,6,1,0,18,6,12,0
B541,29,17,12,5,0,12,5,7,0
B540,24,8,4,4,0,16,4,12,0
B547,28,18,14,4,0,10,3,6,1
B546,29,21,10,9,2,8,4,3,1
B545,27,15,7,8,0,12,4,7,1
B544,27,8,4,3,1,19,7,12,0
B549,32,25,14,8,3,7,3,2,2
B548,27,4,1,3,0,23,9,14,0
Q807,29,10,6,3,1,19,6,10,3
Q806,30,4,3,1,0,26,8,14,4
Q553,26,15,8,7,0,11,4,6,1
Q804,33,15,9,4,2,18,1,16,1
Q803,28,7,6,1,0,21,5,15,1
Q554,31,19,10,7,2,12,4,6,2
Q557,31,20,14,3,3,11,1,9,1
Q800,27,9,5,4,0,18,7,10,1
Q559,33,20,13,3,4,13,4,7,2
Q558,28,13,7,5,1,15,6,9,0
Q809,30,20,14,3,3,10,1,8,1
Q808,29,12,6,5,1,17,5,9,3
K672,27,15,8,6,1,12,4,8,0
K673,29,15,12,2,1,14,5,8,1
K670,28,18,13,5,0,10,3,6,1
K671,32,21,12,3,6,11,2,7,2
K676,28,12,11,1,0,16,5,9,2
K677,27,13,8,5,0,14,4,9,1
K674,30,14,11,1,2,16,6,9,1
K675,30,15,11,1,3,15,5,8,2
O618,33,12,6,4,2,21,8,12,1
K678,28,20,12,8,0,8,2,5,1
K679,32,18,8,9,1,14,4,8,2
L794,31,25,18,7,0,6,1,3,2
L795,26,6,5,1,0,20,7,13,0
L796,33,21,13,6,2,12,3,5,4
L797,30,7,4,2,1,23,9,13,1
L790,32,22,16,3,3,10,0,7,3
L791,31,11,6,3,2,20,6,14,0
L792,31,18,12,5,1,13,1,9,3
L793,33,24,15,6,3,9,1,5,3
L798,31,19,10,6,3,12,1,7,4
L799,32,15,9,4,2,17,5,10,2
O786,32,28,17,8,3,4,2,1,1
O787,29,14,7,5,2,15,2,11,2
O784,27,5,3,2,0,22,9,13,0
O785,30,21,11,9,1,9,1,7,1
O782,30,16,7,9,0,14,7,6,1
O783,32,14,10,2,2,18,6,10,2
O780,30,19,14,5,0,11,3,5,3
O781,30,25,13,9,3,5,2,2,1
O788,30,11,7,3,1,19,8,10,1
O789,34,29,14,12,3,5,2,3,0
A696,25,12,7,5,0,13,3,10,0
A695,31,15,9,5,1,16,7,7,2
A692,25,13,8,5,0,12,4,7,1
A693,24,8,5,2,1,16,3,11,2
A690,28,19,9,7,3,9,3,6,0
A698,30,16,10,3,3,14,5,7,2
A699,29,16,9,6,1,13,5,7,1
R851,32,20,9,8,3,12,4,7,1
R850,31,12,8,3,1,19,3,15,1
R853,31,17,11,4,2,14,4,7,3
R852,30,17,10,6,1,13,5,7,1
R855,29,14,8,6,0,15,4,8,3
R854,29,12,6,5,1,17,4,11,2
N503,34,22,11,8,3,12,3,8,1
N502,29,8,5,1,2,21,10,9,2
N507,31,15,10,5,0,16,4,12,0
N506,29,20,8,8,4,9,1,7,1
N505,24,7,5,2,0,17,5,11,1
N504,30,16,12,2,2,14,5,7,2
N509,31,24,13,11,0,7,1,6,0
N508,28,4,3,1,0,24,6,15,3
R509,30,10,7,3,0,20,6,14,0
R508,32,9,4,4,1,23,7,14,2
R507,34,24,12,11,1,10,4,5,1
R506,31,9,6,3,0,22,5,14,3
R505,29,9,5,3,1,20,6,12,2
R504,32,20,13,4,3,12,3,8,1
R503,31,25,14,7,4,6,1,4,1
R502,28,15,11,3,1,13,2,10,1
E586,27,12,6,5,1,15,5,9,1
E587,30,18,12,4,2,12,3,7,2
E585,25,10,8,2,0,15,2,13,0
E582,25,13,8,5,0,12,2,9,1
E583,27,9,6,3,0,18,6,11,1
E580,25,4,3,1,0,21,8,13,0
E581,26,13,6,6,1,13,5,8,0
E588,27,16,9,7,0,11,3,7,1
E589,29,14,8,5,1,15,3,11,1
M586,31,18,10,7,1,13,2,8,3
O800,29,17,8,6,3,12,2,9,1
O802,33,22,15,5,2,11,2,6,3
O805,31,23,12,9,2,8,3,4,1
O804,31,15,7,5,3,16,3,11,2
O807,30,12,8,3,1,18,5,11,2
O806,30,12,6,4,2,18,5,11,2
K805,29,23,13,7,3,6,1,5,0
K804,28,6,4,2,0,22,5,15,2
K807,27,16,7,8,1,11,5,4,2
K806,27,7,4,2,1,20,8,11,1
K801,27,11,6,2,3,16,3,11,2
K800,26,11,6,2,3,15,4,10,1
K803,27,3,1,1,1,24,8,15,1
K802,27,10,7,3,0,17,5,11,1
K809,27,12,8,3,1,15,5,7,3
K808,27,5,3,2,0,22,9,11,2
B756,26,12,7,5,0,14,6,7,1
B757,25,10,9,1,0,15,3,11,1
B754,26,11,8,3,0,15,5,10,0
B755,26,14,10,4,0,12,2,9,1
B752,26,17,8,8,1,9,3,6,0
B753,27,16,11,5,0,11,4,7,0
B751,26,8,7,1,0,18,3,14,1
B758,27,16,12,4,0,11,3,8,0
P509,31,22,10,10,2,9,4,5,0
P508,28,4,2,2,0,24,7,17,0
F520,28,16,8,7,1,12,6,5,1
P503,34,22,13,4,5,12,2,9,1
P502,28,14,10,3,1,14,4,10,0
P505,25,10,6,4,0,15,4,10,1
F523,29,10,8,1,1,19,6,12,1
P507,32,16,7,7,2,16,6,8,2
P506,32,15,8,4,3,17,3,13,1
F522,25,10,6,3,1,15,2,12,1
F525,12,5,1,3,1,7,1,6,0
F527,30,26,17,6,3,4,0,4,0
F526,29,15,9,6,0,14,2,9,3
C728,29,17,10,5,2,12,2,6,4
C729,27,15,11,4,0,12,2,8,2
C724,30,18,12,6,0,12,2,8,2
C725,27,13,10,3,0,14,5,9,0
C726,27,10,5,3,2,17,9,8,0
C727,31,22,12,8,2,9,0,6,3
C720,30,8,7,1,0,22,10,8,4
C721,31,21,14,6,1,10,3,5,2
C722,27,21,15,6,0,6,2,3,1
C723,28,12,7,4,1,16,6,9,1
K588,30,19,10,8,1,11,3,7,1
K589,28,9,4,4,1,19,8,10,1
K580,29,13,7,5,1,16,6,8,2
K581,28,7,4,3,0,21,9,12,0
K582,29,14,9,5,0,15,2,9,4
K583,26,6,5,1,0,20,8,11,1
K585,26,12,7,4,1,14,4,9,1
K586,28,15,9,6,0,13,5,8,0
K587,29,10,7,2,1,19,7,11,1
G728,31,25,12,10,3,6,3,2,1
G729,28,7,6,0,1,21,8,12,1
G720,30,23,15,5,3,7,2,5,0
G721,31,27,16,7,4,4,0,4,0
G722,31,23,13,5,5,8,2,5,1
G723,29,13,9,3,1,16,6,9,1
G724,30,17,9,5,3,13,3,8,2
G725,30,22,15,5,2,8,0,6,2
G726,27,10,7,3,0,17,7,8,2
G727,28,18,10,6,2,10,2,7,1
N716,28,8,3,3,2,20,7,12,1
N717,32,18,12,3,3,14,3,8,3
N714,33,23,11,8,4,10,4,4,2
N715,30,17,13,4,0,13,4,8,1
N712,30,18,7,10,1,12,5,6,1
N713,25,6,5,1,0,19,5,14,0
N710,29,7,5,2,0,22,6,14,2
N711,31,19,11,7,1,12,4,6,2
N718,33,21,10,7,4,12,0,9,3
N719,32,15,11,2,2,17,2,13,2
F708,31,25,14,10,1,6,2,3,1
F701,30,18,12,4,2,12,4,7,1
F700,28,7,5,2,0,21,6,14,1
F703,28,16,10,5,1,12,5,6,1
F702,27,13,6,6,1,14,6,7,1
F705,27,13,7,6,0,14,6,8,0
F704,28,15,7,8,0,13,5,6,2
F707,29,12,7,4,1,17,4,12,1
J576,28,17,8,8,1,11,3,7,1
J577,30,25,14,5,6,5,1,4,0
J574,29,13,8,3,2,16,5,11,0
J575,29,13,9,3,1,16,6,9,1
J572,28,18,10,6,2,10,1,8,1
J573,29,19,14,4,1,10,2,7,1
J570,31,11,7,3,1,20,6,10,4
J571,32,19,9,6,4,13,1,11,1
J578,30,8,4,3,1,22,9,11,2
J579,27,11,8,2,1,16,4,12,0
R712,32,20,7,10,3,12,8,2,2
R713,32,11,6,4,1,21,6,13,2
R710,31,12,6,4,2,19,4,14,1
R711,30,11,7,2,2,19,7,11,1
R716,27,19,9,8,2,8,1,7,0
R717,34,25,17,4,4,9,2,5,2
R714,31,17,12,5,0,14,3,6,5
R715,32,13,8,3,2,19,11,7,1
R718,30,14,8,6,0,16,2,13,1
R719,33,24,16,7,1,9,2,6,1
Q713,27,3,2,1,0,24,9,12,3
Q712,31,14,7,6,1,17,5,11,1
Q711,29,15,8,5,2,14,4,8,2
Q710,31,15,10,5,0,16,3,12,1
Q717,33,22,16,5,1,11,1,5,5
Q716,29,13,8,5,0,16,3,11,2
Q715,31,18,11,4,3,13,5,7,1
Q714,31,18,12,4,2,13,3,9,1
Q719,33,26,15,8,3,7,1,6,0
Q718,31,16,8,8,0,15,5,8,2
B569,27,13,12,1,0,14,3,10,1
B568,25,15,7,8,0,10,4,6,0
B561,25,14,7,5,2,11,4,7,0
B560,29,21,12,8,1,8,1,7,0
B562,30,15,11,3,1,15,3,9,3
B565,28,13,6,7,0,15,6,9,0
B564,27,13,8,5,0,14,5,9,0
B567,25,17,7,8,2,8,3,5,0
B566,25,3,2,1,0,22,9,13,0
Q829,32,13,9,2,2,19,6,9,4
Q828,34,23,10,11,2,11,4,6,1
Q825,34,28,13,10,5,6,1,3,2
Q824,32,15,11,1,3,17,5,11,1
Q827,34,24,13,6,5,10,5,5,0
Q826,31,20,12,8,0,11,3,8,0
Q821,30,5,5,0,0,25,9,12,4
Q820,30,16,6,8,2,14,5,8,1
Q823,28,16,10,5,1,12,2,9,1
Q822,31,16,12,4,0,15,4,10,1
K619,29,7,4,1,2,22,5,13,4
K610,31,16,7,5,4,15,7,8,0
K611,27,12,6,6,0,15,6,8,1
K612,27,13,7,6,0,14,6,8,0
K613,28,17,14,3,0,11,3,7,1
K614,27,14,7,6,1,13,2,10,1
K615,30,24,13,9,2,6,0,5,1
K616,32,20,11,7,2,12,3,7,2
K617,28,19,11,7,1,9,2,7,0
O768,30,15,7,6,2,15,6,8,1
O769,31,15,11,2,2,16,5,9,2
O764,31,19,13,5,1,12,4,6,2
O765,29,20,10,6,4,9,2,6,1
O766,33,27,17,9,1,6,0,5,1
O767,29,12,9,3,0,17,7,6,4
O760,29,6,3,3,0,23,9,14,0
O761,27,15,10,4,1,12,1,9,2
O762,29,6,3,2,1,23,10,12,1
O763,31,17,10,6,1,14,3,10,1
A678,28,16,9,6,1,12,5,6,1
A679,29,20,10,8,2,9,3,6,0
A674,26,11,9,1,1,15,3,10,2
A675,29,22,10,8,4,7,3,4,0
A676,31,17,14,3,0,14,3,8,3
A677,27,12,7,5,0,15,6,8,1
A670,31,20,13,6,1,11,2,7,2
A671,29,14,10,4,0,15,5,8,2
A672,25,13,8,5,0,12,4,7,1
A673,30,18,11,5,2,12,4,7,1
N529,30,17,9,6,2,13,4,8,1
N528,30,17,9,8,0,13,6,6,1
N521,33,19,12,2,5,14,5,7,2
N520,31,14,10,3,1,17,6,10,1
N523,30,14,5,7,2,16,4,10,2
N522,31,19,11,7,1,12,2,8,2
N524,30,22,11,9,2,8,2,6,0
N527,33,22,15,5,2,11,4,5,2
N526,30,18,12,6,0,12,3,8,1
R524,29,2,1,1,0,27,12,14,1
R527,33,16,12,3,1,17,6,8,3
R526,29,19,13,5,1,10,1,8,1
R521,31,17,11,4,2,14,5,7,2
R520,29,14,7,7,0,15,8,6,1
R523,32,12,7,2,3,20,4,15,1
R522,30,24,12,8,4,6,0,5,1
R529,30,11,10,1,0,19,5,12,2
R528,29,17,9,7,1,12,3,8,1
Q556,32,21,12,4,5,11,2,7,2
C557,26,18,10,8,0,8,3,4,1
C556,26,12,10,2,0,14,5,8,1
C555,27,10,6,4,0,17,4,13,0
C554,27,22,14,8,0,5,2,3,0
E568,25,12,6,5,1,13,3,9,1
C552,27,12,9,3,0,15,4,11,0
C551,31,18,11,5,2,13,3,8,2
C550,24,12,7,5,0,12,4,8,0
E564,25,7,5,2,0,18,7,11,0
E565,29,19,11,7,1,10,1,8,1
E566,26,8,6,1,1,18,6,12,0
E567,26,8,5,2,1,18,5,13,0
E560,30,15,6,7,2,15,5,9,1
E561,26,9,4,4,1,17,7,9,1
E562,32,23,10,9,4,9,3,6,0
C558,25,10,4,5,1,15,6,7,2
M564,31,23,10,9,4,8,3,5,0
M565,29,19,9,9,1,10,3,5,2
M566,26,2,2,0,0,24,9,15,0
M567,27,9,5,3,1,18,6,12,0
M560,34,14,5,4,5,20,5,14,1
M561,26,21,11,10,0,5,1,4,0
M562,31,21,15,5,1,10,2,7,1
M563,29,8,4,4,0,21,10,11,0
M568,31,25,11,11,3,6,2,3,1
M569,31,21,14,6,1,10,3,6,1
E533,27,16,7,7,2,11,4,6,1
D589,27,12,6,6,0,15,6,8,1
D588,27,11,7,4,0,16,6,9,1
D585,24,8,5,3,0,16,3,12,1
D855,26,13,7,5,1,13,3,7,3
D586,26,15,8,6,1,11,4,6,1
D581,25,5,2,3,0,20,9,9,2
D580,26,3,2,1,0,23,9,13,1
D851,26,8,7,1,0,18,6,10,2
D582,25,8,5,2,1,17,6,9,2
C522,25,8,4,4,0,17,5,12,0
C523,26,1,1,0,0,25,11,14,0
C520,26,19,12,7,0,7,1,5,1
C521,28,14,10,2,2,14,4,9,1
J608,24,12,7,5,0,12,3,8,1
J604,28,8,7,0,1,20,9,9,2
J605,28,13,7,5,1,15,4,11,0
J606,30,19,12,4,3,11,3,6,2
J607,29,25,13,6,6,4,0,3,1
J600,27,14,9,4,1,13,1,9,3
J601,28,16,9,5,2,12,2,9,1
J602,29,16,10,5,1,13,2,8,3
J603,29,17,10,4,3,12,5,5,2
O597,32,14,11,3,0,18,6,11,1
O596,28,2,2,0,0,26,10,15,1
C708,33,30,15,9,6,3,1,2,0
O594,31,6,3,3,0,25,9,15,1
O593,30,8,5,3,0,22,6,13,3
O592,33,21,13,5,3,12,4,5,3
O591,29,8,5,3,0,21,8,13,0
O590,28,12,7,5,0,16,4,10,2
C702,27,15,11,2,2,12,3,8,1
C703,27,15,9,6,0,12,6,6,0
C700,26,9,7,1,1,17,6,11,0
C701,30,23,15,6,2,7,1,6,0
C707,25,5,3,2,0,20,4,16,0
C704,27,14,9,5,0,13,5,7,1
C705,27,18,10,8,0,9,1,8,0
P783,31,15,11,3,1,16,5,8,3
P782,33,20,8,9,3,13,3,8,2
P781,31,23,13,6,4,8,2,4,2
P780,30,11,8,1,2,19,7,10,2
P787,28,7,4,2,1,21,7,12,2
P786,33,26,16,7,3,7,3,3,1
P785,31,14,6,6,2,17,7,10,0
P784,30,8,5,3,0,22,7,12,3
P789,32,25,14,7,4,7,0,4,3
P788,33,11,8,1,2,22,8,11,3
M685,30,15,6,6,3,15,4,8,3
M687,29,16,12,4,0,13,2,9,2
M686,32,18,8,10,0,14,7,7,0
M681,28,13,9,3,1,15,3,12,0
M680,28,12,5,5,2,16,6,9,1
M683,31,21,12,7,2,10,0,7,3
M682,28,13,9,4,0,15,3,12,0
M689,27,14,9,4,1,13,2,11,0
M688,27,11,7,3,1,16,4,12,0
H699,30,17,10,5,2,13,3,10,0
H698,29,11,9,0,2,18,6,10,2
H695,30,18,13,3,2,12,3,7,2
H690,31,17,7,8,2,14,7,6,1
H693,26,1,0,1,0,25,9,14,2
H692,26,7,6,1,0,19,7,11,1
G707,29,10,5,5,0,19,5,12,2
G704,32,18,8,5,5,14,4,8,2
G705,26,1,1,0,0,25,10,15,0
G702,29,18,10,5,3,11,4,6,1
G703,28,14,7,7,0,14,4,8,2
G700,27,10,6,4,0,17,7,9,1
G701,29,16,14,2,0,13,5,8,0
G708,28,8,6,1,1,20,9,9,2
E797,27,8,6,2,0,19,4,14,1
E796,28,12,8,4,0,16,7,9,0
E795,27,10,5,4,1,17,6,9,2
E794,28,8,5,2,1,20,7,12,1
E793,31,23,13,6,4,8,1,6,1
E792,26,14,9,4,1,12,3,9,0
E791,29,7,5,1,1,22,5,14,3
E790,29,23,15,7,1,6,1,3,2
E799,28,11,5,6,0,17,7,9,1
E798,31,18,8,7,3,13,3,7,3
F855,28,17,8,6,3,11,2,7,2
F854,27,10,6,4,0,17,5,10,2
F851,28,17,13,4,0,11,3,8,0
F850,24,8,5,3,0,16,4,11,1
F853,28,21,13,7,1,7,1,5,1
F852,29,20,12,7,1,9,1,7,1
F583,27,13,9,3,1,14,3,11,0
F582,26,15,6,7,2,11,4,7,0
F581,28,3,3,0,0,25,11,13,1
F580,23,4,3,1,0,19,7,12,0
F587,29,13,10,3,0,16,4,9,3
J599,29,22,9,8,5,7,3,4,0
F585,27,7,5,1,1,20,5,14,1
J594,29,12,7,3,2,17,7,9,1
J595,30,11,8,3,0,19,7,8,4
F589,28,12,5,6,1,16,5,9,2
F588,28,13,7,6,0,15,4,10,1
J590,27,10,3,7,0,17,8,8,1
J592,30,23,13,5,5,7,3,4,0
J593,29,14,7,6,1,15,3,11,1
R778,31,16,11,4,1,15,5,7,3
R779,31,18,11,5,2,13,3,7,3
R770,28,8,3,4,1,20,7,11,2
R771,31,12,10,2,0,19,8,10,1
R772,32,23,10,9,4,9,1,7,1
R773,29,20,9,8,3,9,0,8,1
R774,29,9,7,2,0,20,5,12,3
R775,29,14,8,5,1,15,6,9,0
R776,30,12,6,6,0,18,6,11,1
R777,29,5,3,2,0,24,10,14,0
Q739,31,18,9,9,0,13,4,8,1
Q738,33,21,13,5,3,12,4,5,3
Q731,33,17,11,4,2,16,7,8,1
Q730,28,9,5,4,0,19,7,10,2
Q733,30,15,8,5,2,15,3,11,1
Q732,30,6,2,1,3,24,9,14,1
Q735,28,13,6,7,0,15,8,7,0
Q734,29,11,6,3,2,18,3,11,4
Q737,32,15,11,4,0,17,6,8,3
Q736,28,17,9,8,0,11,2,8,1
Q849,33,24,14,7,3,9,4,4,1
Q848,30,10,5,4,1,20,5,11,4
Q843,32,19,11,4,4,13,5,6,2
Q842,28,22,13,7,2,6,0,6,0
Q841,30,14,8,4,2,16,3,8,5
Q840,31,21,15,6,0,10,2,5,3
Q847,31,5,3,2,0,26,9,14,3
Q846,31,26,14,10,2,5,1,1,3
Q845,32,19,12,7,0,13,3,9,1
Q844,28,13,10,3,0,15,2,13,0
K636,31,24,14,6,4,7,2,2,3
K637,28,15,13,2,0,13,4,8,1
K634,28,15,9,6,0,13,5,6,2
K635,28,5,3,1,1,23,11,11,1
K632,31,14,9,4,1,17,2,13,2
K633,27,1,1,0,0,26,11,15,0
K630,26,8,4,4,0,18,5,13,0
K631,27,17,9,6,2,10,1,7,2
K638,26,11,5,5,1,15,5,8,2
K639,32,24,12,8,4,8,2,5,1
J567,26,9,8,1,0,17,4,13,0
O748,28,12,7,5,0,16,5,7,4
O749,29,14,9,3,2,15,5,9,1
O742,30,7,6,1,0,23,10,12,1
O743,34,26,14,7,5,8,1,6,1
O740,29,17,11,6,0,12,3,8,1
O741,32,23,13,8,2,9,2,6,1
O746,31,14,12,1,1,17,6,9,2
O747,29,15,7,7,1,14,3,10,1
O744,33,17,7,8,2,16,6,9,1
O745,34,23,12,10,1,11,3,7,1
Q595,33,24,15,5,4,9,2,5,2
Q594,28,8,2,5,1,20,9,9,2
Q597,31,11,7,3,1,20,5,12,3
Q596,29,10,9,1,0,19,6,13,0
Q591,31,14,8,5,1,17,5,11,1
Q590,29,10,5,4,1,19,5,11,3
Q593,31,8,3,3,2,23,8,12,3
Q592,33,23,14,4,5,10,2,7,1
Q599,31,10,6,2,2,21,8,12,1
Q598,29,13,7,5,1,16,5,10,1
A658,28,17,10,7,0,11,2,8,1
A659,28,22,13,8,1,6,1,4,1
A652,27,16,9,6,1,11,3,5,3
A653,26,11,5,5,1,15,6,6,3
A650,27,10,6,2,2,17,5,9,3
A651,30,19,10,7,2,11,4,5,2
A657,28,15,7,6,2,13,6,6,1
A654,26,7,5,2,0,19,6,12,1
A655,28,11,10,1,0,17,8,7,2
I667,29,11,9,1,1,18,2,15,1
I666,28,21,15,6,0,7,0,5,2
I665,29,8,3,4,1,21,9,11,1
I664,24,8,7,1,0,16,3,13,0
I663,29,10,8,2,0,19,7,10,2
I662,30,19,12,4,3,11,4,5,2
I661,29,12,8,4,0,17,5,8,4
I660,28,17,13,4,0,11,3,6,2
I669,28,17,9,6,2,11,3,6,2
I668,29,13,10,3,0,16,8,6,2
J836,31,19,10,8,1,12,2,7,3
J835,28,20,13,6,1,8,1,6,1
J834,26,9,7,2,0,17,4,12,1
J833,27,5,4,1,0,22,6,13,3
J832,25,7,4,3,0,18,7,11,0
J831,28,15,12,3,0,13,3,8,2
J830,29,14,10,2,2,15,5,9,1
J839,31,26,16,8,2,5,0,4,1
J838,30,13,6,7,0,17,6,11,0
H598,28,11,7,3,1,17,5,10,2
H599,29,12,7,5,0,17,4,10,3
H596,28,2,1,1,0,26,13,13,0
H597,28,20,14,6,0,8,1,7,0
H594,28,7,4,2,1,21,10,11,0
H595,29,14,12,1,1,15,5,8,2
H592,31,24,15,7,2,7,1,3,3
H593,29,17,9,7,1,12,4,7,1
H590,27,6,3,1,2,21,6,15,0
R542,28,11,6,5,0,17,7,8,2
R541,31,18,11,7,0,13,3,9,1
R540,30,11,6,4,1,19,7,9,3
R547,30,11,7,4,0,19,9,9,1
R546,32,21,12,5,4,11,3,6,2
R545,28,16,8,6,2,12,3,8,1
R544,30,13,6,7,0,17,6,10,1
R549,33,22,13,4,5,11,5,5,1
R548,28,7,5,2,0,21,5,15,1
E548,27,9,6,3,0,18,5,12,1
E549,31,28,14,10,4,3,1,1,1
C579,25,14,7,7,0,11,4,7,0
C578,30,11,7,2,2,19,6,10,3
C575,27,3,3,0,0,24,9,13,2
C574,27,22,11,11,0,5,2,3,0
C577,31,28,17,9,2,3,0,2,1
C576,28,13,6,6,1,15,3,9,3
C571,24,6,4,2,0,18,5,13,0
C570,27,18,11,6,1,9,2,7,0
C573,29,6,3,3,0,23,10,9,4
E545,26,6,4,1,1,20,5,12,3
M542,26,10,6,3,1,16,5,11,0
M543,30,9,5,3,1,21,6,14,1
M540,29,9,6,3,0,20,8,11,1
M541,31,6,5,0,1,25,9,15,1
M546,33,20,13,4,3,13,3,7,3
M547,29,16,11,4,1,13,3,7,3
M544,30,14,8,6,0,16,6,10,0
M545,26,6,5,1,0,20,6,14,0
M548,25,8,4,3,1,17,4,13,0
M549,31,13,10,3,0,18,7,10,1
K849,30,19,14,2,3,11,2,8,1
K848,28,21,13,7,1,7,1,6,0
K841,28,11,8,2,1,17,5,9,3
K840,30,24,17,6,1,6,2,3,1
K843,29,19,12,5,2,10,2,4,4
K842,25,8,5,3,0,17,7,10,0
K845,28,20,12,8,0,8,2,6,0
K844,30,14,10,2,2,16,4,10,2
K847,28,8,5,3,0,20,8,12,0
K846,31,23,13,8,2,8,2,3,3
A582,24,1,0,1,0,23,10,12,1
A583,27,16,10,5,1,11,3,8,0
A852,26,11,9,2,0,15,4,10,1
A581,27,22,11,8,3,5,1,4,0
A586,25,5,3,2,0,20,8,10,2
A587,27,13,9,4,0,14,5,8,1
L699,31,27,14,10,3,4,1,2,1
L698,29,15,10,2,3,14,4,8,2
L690,29,6,4,2,0,23,8,11,4
L693,30,13,6,6,1,17,3,10,4
L692,28,12,5,5,2,16,7,9,0
L695,33,18,13,2,3,15,6,7,2
B798,26,12,10,2,0,14,4,10,0
B799,28,9,6,3,0,19,7,12,0
B792,26,13,7,6,0,13,4,7,2
B793,27,16,12,4,0,11,1,9,1
B790,27,11,11,0,0,16,6,10,0
B791,27,9,6,2,1,18,4,14,0
B796,28,19,9,9,1,9,3,4,2
B797,25,9,6,3,0,16,5,11,0
B794,27,9,7,2,0,18,8,9,1
B795,27,15,12,3,0,12,1,11,0
Q697,16,1,0,1,0,15,3,11,1
Q694,28,13,4,6,3,15,3,11,1
Q695,34,22,13,5,4,12,6,4,2
Q692,28,2,1,1,0,26,11,15,0
Q693,29,9,5,4,0,20,5,13,2
Q690,30,4,3,1,0,26,11,14,1
Q698,30,12,9,3,0,18,8,9,1
Q699,31,25,14,9,2,6,2,2,2
I780,30,18,12,4,2,12,3,6,3
I781,28,16,8,5,3,12,3,7,2
I782,29,17,9,6,2,12,2,8,2
I783,30,29,14,10,5,1,0,1,0
I784,25,10,6,4,0,15,6,8,1
I785,30,10,5,4,1,20,9,10,1
I786,28,21,14,6,1,7,3,3,1
I787,22,11,6,5,0,11,3,8,0
I788,29,12,8,3,1,17,9,7,1
I789,28,15,8,6,1,13,5,5,3
J628,32,21,13,3,5,11,3,6,2
J629,29,18,13,4,1,11,3,7,1
J622,26,13,8,5,0,13,4,8,1
J623,33,32,15,8,9,1,0,1,0
J620,28,7,5,2,0,21,6,13,2
J621,25,7,5,1,1,18,6,11,1
J626,31,11,10,0,1,20,4,12,4
J627,31,15,9,3,3,16,4,11,1
J624,29,16,9,5,2,13,5,7,1
J625,28,15,12,2,1,13,3,8,2
D707,27,15,10,4,1,12,3,9,0
D705,27,12,4,8,0,15,4,9,2
D704,29,17,10,6,1,12,0,9,3
D703,30,14,10,2,2,16,2,10,4
D702,29,21,10,7,4,8,1,6,1
D701,31,23,18,3,2,8,1,6,1
D700,27,4,3,0,1,23,7,14,2
D708,33,24,15,7,2,9,3,5,1
C761,24,4,2,2,0,20,8,12,0
C762,24,11,6,5,0,13,4,9,0
C764,28,14,10,4,0,14,6,6,2
C765,25,9,7,2,0,16,4,12,0
C766,29,17,13,4,0,12,3,9,0
C767,27,17,12,4,1,10,4,5,1
C768,27,21,14,7,0,6,1,5,0
C769,30,23,13,5,5,7,1,5,1
K548,30,11,6,3,2,19,2,15,2
K549,30,18,13,3,2,12,4,7,1
K544,29,18,11,7,0,11,4,7,0
K545,25,10,4,6,0,15,5,9,1
K546,30,18,8,9,1,12,6,5,1
K547,28,15,9,4,2,13,3,8,2
K540,28,10,5,5,0,18,8,9,1
K541,29,9,4,4,1,20,9,10,1
K543,26,3,2,1,0,23,10,13,0
F833,29,5,4,0,1,24,7,14,3
F832,26,7,5,2,0,19,6,12,1
F831,27,8,6,1,1,19,9,10,0
F830,28,20,14,5,1,8,1,7,0
F836,28,7,5,2,0,21,8,12,1
F835,28,22,11,9,2,6,2,4,0
F834,27,5,3,2,0,22,8,11,3
F839,29,19,13,6,0,10,3,6,1
F838,29,16,11,4,1,13,3,9,1
R756,28,8,4,4,0,20,9,9,2
R757,29,9,6,3,0,20,6,13,1
R754,30,20,12,4,4,10,1,6,3
R755,29,13,6,6,1,16,7,5,4
R752,31,10,6,4,0,21,6,12,3
R753,32,14,8,4,2,18,6,9,3
R750,29,9,5,3,1,20,7,13,0
R751,31,14,6,6,2,17,6,10,1
R758,30,19,12,7,0,11,5,5,1
R759,31,17,9,7,1,14,3,10,1
F537,26,18,11,7,0,8,1,6,1
O605,31,11,8,1,2,20,5,12,3
O604,31,14,12,0,2,17,4,12,1
F533,27,12,7,4,1,15,4,11,0
O608,27,6,3,2,1,21,7,13,1
O720,34,27,17,6,4,7,1,5,1
O721,31,13,11,1,1,18,4,10,4
O722,32,22,15,3,4,10,1,7,2
O723,34,26,15,8,3,8,0,6,2
O724,32,19,9,8,2,13,3,8,2
O725,32,16,11,4,1,16,8,7,1
O726,31,14,9,4,1,17,6,9,2
O727,31,20,11,9,0,11,4,6,1
O728,28,6,3,3,0,22,10,12,0
O729,31,11,7,3,1,20,9,8,3
I648,27,8,6,1,1,19,6,13,0
I645,31,17,12,4,1,14,2,10,2
I644,28,18,11,5,2,10,1,9,0
I647,26,5,4,1,0,21,8,13,0
I646,26,5,3,1,1,21,9,12,0
I641,30,10,5,4,1,20,8,6,6
I640,30,26,11,7,8,4,2,2,0
I643,25,7,7,0,0,18,5,11,2
I642,26,16,9,7,0,10,2,7,1
A632,27,14,5,8,1,13,2,8,3
A633,28,15,10,4,1,13,3,9,1
A634,25,8,5,1,2,17,4,13,0
A635,30,10,5,2,3,20,8,8,4
A636,29,25,15,8,2,4,1,2,1
A637,27,16,10,5,1,11,4,6,1
J815,27,15,8,4,3,12,2,10,0
A639,26,13,9,3,1,13,4,8,1
J817,28,15,8,6,1,13,6,6,1
J816,29,19,11,7,1,10,2,7,1
J811,29,19,10,5,4,10,1,9,0
J810,28,18,12,6,0,10,3,5,2
J813,28,10,7,2,1,18,5,12,1
J812,24,5,3,2,0,19,7,12,0
R569,31,17,13,2,2,14,4,8,2
R568,32,25,11,9,5,7,1,4,2
R561,30,12,3,7,2,18,10,8,0
R560,31,7,3,4,0,24,7,14,3
R563,26,10,5,3,2,16,4,11,1
R562,34,27,15,7,5,7,2,5,0
R565,29,12,4,5,3,17,7,10,0
R564,30,12,4,6,2,18,7,10,1
R567,27,8,5,3,0,19,7,12,0
R566,27,12,8,4,0,15,4,11,0
D534,28,4,2,2,0,24,9,13,2
D535,29,20,12,6,2,9,3,4,2
D824,27,15,13,2,0,12,4,7,1
E520,29,21,11,6,4,8,2,6,0
E521,28,13,10,2,1,15,7,7,1
E522,26,5,4,1,0,21,9,12,0
E523,29,14,7,5,2,15,2,12,1
E526,27,12,7,5,0,15,7,8,0
E527,30,11,7,1,3,19,8,9,2
E528,29,7,4,2,1,22,7,11,4
D530,28,17,13,3,1,11,2,8,1
C519,26,15,9,6,0,11,2,9,0
C518,28,15,11,3,1,13,3,7,3
C513,28,15,9,5,1,13,7,6,0
C512,31,18,14,4,0,13,4,7,2
C511,31,27,15,10,2,4,0,2,2
D533,27,14,7,4,3,13,3,8,2
C517,26,7,5,2,0,19,8,11,0
C516,29,20,12,8,0,9,2,7,0
C515,30,23,15,5,3,7,0,5,2
C514,25,3,2,1,0,22,6,16,0
G517,26,10,6,4,0,16,6,9,1
G516,29,13,7,3,3,16,4,9,3
G515,29,14,11,3,0,15,5,7,3
G514,28,2,2,0,0,26,7,19,0
G513,27,16,9,7,0,11,2,8,1
G512,28,14,11,2,1,14,5,8,1
G511,31,22,9,6,7,9,4,5,0
G510,26,8,5,3,0,18,6,11,1
G519,29,11,7,3,1,18,4,11,3
G518,28,12,11,0,1,16,5,9,2
M528,31,14,7,6,1,17,6,10,1
M529,30,13,8,4,1,17,5,10,2
M520,30,6,5,1,0,24,10,13,1
M521,30,20,11,6,3,10,4,4,2
M522,32,24,10,9,5,8,1,5,2
M523,29,9,4,4,1,20,8,10,2
M524,30,14,9,5,0,16,6,10,0
M526,32,24,10,12,2,8,5,3,0
M527,31,14,11,2,1,17,8,7,2
Q678,31,15,7,8,0,16,7,6,3
Q679,32,12,7,5,0,20,5,12,3
Q674,33,20,12,4,4,13,2,8,3
Q675,32,21,15,3,3,11,3,6,2
Q676,34,30,16,7,7,4,1,3,0
Q677,30,10,6,2,2,20,7,13,0
Q670,32,23,14,5,4,9,1,6,2
Q671,34,27,17,7,3,7,1,4,2
Q672,30,24,13,10,1,6,1,4,1
Q673,33,19,13,3,3,14,6,6,2
J640,30,25,14,7,4,5,1,3,1
J641,29,10,4,5,1,19,7,9,3
J642,27,8,6,2,0,19,6,13,0
J643,25,14,8,6,0,11,4,7,0
J644,28,13,7,5,1,15,5,10,0
J645,27,12,7,5,0,15,5,10,0
J646,26,14,10,4,0,12,2,9,1
J647,30,10,8,1,1,20,5,13,2
J648,28,13,9,4,0,15,3,11,1
J649,30,1,1,0,0,29,10,15,4
D758,29,14,10,3,1,15,4,9,2
D813,28,19,10,8,1,9,2,4,3
D812,26,12,7,5,0,14,5,9,0
D811,29,13,10,2,1,16,2,12,2
D810,30,22,16,5,1,8,1,5,2
D817,27,15,9,6,0,12,6,5,1
D816,28,11,7,3,1,17,4,10,3
D815,27,7,5,2,0,20,7,13,0
D814,28,10,6,4,0,18,4,14,0
D819,24,9,5,4,0,15,5,10,0
D818,27,15,10,5,0,12,5,7,0
D754,25,3,3,0,0,22,11,11,0
L539,33,16,8,3,5,17,7,8,2
D729,27,13,8,4,1,14,6,7,1
D728,26,21,11,9,1,5,2,2,1
D725,26,15,9,6,0,11,5,6,0
D724,28,17,10,5,2,11,2,8,1
D727,25,12,9,3,0,13,2,10,1
D726,25,11,11,0,0,14,3,9,2
D721,29,19,13,6,0,10,4,3,3
D720,31,23,14,5,4,8,1,7,0
D723,31,23,12,7,4,8,2,5,1
D722,31,21,11,6,4,10,3,7,0
C749,29,13,7,5,1,16,6,9,1
C746,29,14,10,2,2,15,5,9,1
C747,28,22,12,10,0,6,1,5,0
C744,27,18,11,7,0,9,3,6,0
C745,26,7,2,5,0,19,10,9,0
C742,27,5,3,1,1,22,9,10,3
C743,29,22,13,6,3,7,1,6,0
C740,26,18,12,6,0,8,1,7,0
C741,30,22,12,8,2,8,2,5,1
K568,27,17,11,4,2,10,1,9,0
K569,30,13,11,2,0,17,5,9,3
K562,28,19,14,5,0,9,1,7,1
K560,30,12,7,5,0,18,2,12,4
K561,27,12,6,5,1,15,5,10,0
K566,28,13,5,7,1,15,5,9,1
K567,27,6,4,2,0,21,6,12,3
K564,28,15,6,7,2,13,5,6,2
K565,27,10,5,4,1,17,6,9,2
K574,30,14,12,2,0,16,1,13,2
C755,29,19,10,9,0,10,4,6,0
C754,27,12,6,5,1,15,7,7,1
F819,26,11,7,4,0,15,3,12,0
F818,29,20,13,6,1,9,3,5,1
F811,28,15,8,5,2,13,3,7,3
F810,29,21,12,8,1,8,4,3,1
F813,29,18,11,6,1,11,4,6,1
F812,26,9,7,2,0,17,4,13,0
F815,29,18,9,6,3,11,1,10,0
F814,26,13,7,6,0,13,2,10,1
F817,27,14,11,3,0,13,3,8,2
F816,29,19,11,6,2,10,1,7,2
L718,32,18,9,6,3,14,2,10,2
L719,31,18,10,4,4,13,2,9,2
L714,30,17,9,6,2,13,4,8,1
L715,29,11,9,1,1,18,8,8,2
L716,31,16,8,6,2,15,3,10,2
L717,31,24,18,4,2,7,0,6,1
L710,27,1,1,0,0,26,11,14,1
L711,30,20,10,7,3,10,3,7,0
L712,32,13,10,2,1,19,2,14,3
L713,28,16,9,6,1,12,2,9,1
O708,32,16,13,2,1,16,5,8,3
O709,28,6,3,3,0,22,8,10,4
O706,28,7,5,1,1,21,5,15,1
O707,30,11,6,5,0,19,4,11,4
O704,33,18,8,6,4,15,3,8,4
O705,26,8,6,2,0,18,2,11,5
O702,32,21,11,8,2,11,3,8,0
O703,28,6,4,2,0,22,7,11,4
O700,29,12,8,3,1,17,4,12,1
O701,33,29,17,10,2,4,1,2,1
G852,28,20,12,6,2,8,1,6,1
G853,30,25,13,9,3,5,1,3,1
G850,25,7,5,1,1,18,5,12,1
G851,28,17,11,6,0,11,3,7,1
G854,29,20,10,8,2,9,1,4,4
G855,27,4,4,0,0,23,7,15,1
Q546,30,13,7,6,0,17,7,10,0
Q547,29,8,8,0,0,21,6,14,1
Q816,31,10,5,4,1,21,8,12,1
Q817,32,24,18,5,1,8,1,7,0
Q810,32,18,10,3,5,14,4,7,3
I629,28,16,14,1,1,12,1,10,1
I628,28,16,11,4,1,12,3,7,2
Q540,31,16,10,6,0,15,2,12,1
I623,30,24,12,7,5,6,1,2,3
I622,31,24,11,10,3,7,1,3,3
I621,29,11,5,3,3,18,6,7,5
I620,29,13,8,3,2,16,4,11,1
I627,29,11,7,2,2,18,5,12,1
I626,28,9,6,3,0,19,8,9,2
I625,29,14,6,6,2,15,7,6,2
I624,28,9,7,1,1,19,6,12,1
J789,29,16,8,6,2,13,5,6,2
J788,31,18,13,3,2,13,3,9,1
J785,29,12,8,3,1,17,5,11,1
J784,26,9,5,4,0,17,5,12,0
J787,24,16,8,8,0,8,2,6,0
J786,33,27,16,6,5,6,2,3,1
J781,31,23,13,9,1,8,1,4,3
J780,30,9,5,3,1,21,10,9,2
J783,30,18,10,5,3,12,2,5,5
J782,28,15,9,5,1,13,2,10,1
A619,26,7,6,0,1,19,4,14,1
A616,29,16,9,5,2,13,3,8,2
A617,25,15,8,7,0,10,3,7,0
A615,26,8,5,2,1,18,6,9,3
A612,25,14,8,6,0,11,4,7,0
A613,28,10,8,2,0,18,8,8,2
A610,24,7,2,4,1,17,5,10,2
A611,28,6,4,1,1,22,8,12,2
P808,29,10,5,4,1,19,5,11,3
P809,29,18,12,4,2,11,4,6,1
P804,31,19,9,9,1,12,1,10,1
P805,30,22,13,8,1,8,2,5,1
P806,28,8,5,3,0,20,7,11,2
P807,31,12,8,4,0,19,6,12,1
P800,28,7,4,2,1,21,6,13,2
P801,27,10,7,3,0,17,6,10,1
P802,32,19,12,4,3,13,3,8,2
P803,28,3,2,0,1,25,9,13,3
C683,28,12,8,4,0,16,3,13,0
C682,26,3,2,1,0,23,9,14,0
C681,27,16,9,6,1,11,2,9,0
C680,27,13,9,4,0,14,6,7,1
C687,29,26,15,9,2,3,0,2,1
C686,27,13,7,5,1,14,4,10,0
C685,27,6,5,1,0,21,5,16,0
G687,29,17,9,6,2,12,4,8,0
G686,27,3,2,1,0,24,11,13,0
G685,27,11,7,4,0,16,3,11,2
G684,27,4,4,0,0,23,4,16,3
G683,28,3,1,1,1,25,8,15,2
G682,26,15,9,6,0,11,2,8,1
G681,26,17,9,7,1,9,3,4,2
G680,28,14,7,4,3,14,4,8,2
K530,30,20,13,5,2,10,1,8,1
C531,26,6,4,1,1,20,8,10,2
C530,28,14,10,4,0,14,4,9,1
C533,27,12,8,4,0,15,3,11,1
C535,30,20,14,4,2,10,1,8,1
C534,26,13,8,5,0,13,3,10,0
E508,27,17,9,6,2,10,0,9,1
C536,30,9,4,4,1,21,10,9,2
C539,27,12,9,3,0,15,5,10,0
C538,25,11,8,3,0,14,4,10,0
E504,29,13,12,0,1,16,3,10,3
E505,25,15,9,6,0,10,2,8,0
E502,26,6,4,2,0,20,7,11,2
E503,27,16,10,6,0,11,3,8,0
K533,29,25,13,11,1,4,1,3,0
G539,30,22,17,4,1,8,1,6,1
G538,26,14,10,4,0,12,2,9,1
G535,30,25,11,10,4,5,2,2,1
G534,30,12,7,4,1,18,5,11,2
G537,27,8,6,2,0,19,6,12,1
G536,27,16,14,1,1,11,0,10,1
G531,26,16,8,7,1,10,4,6,0
G530,29,9,6,2,1,20,7,10,3
G533,29,13,7,4,2,16,3,11,2
M506,27,17,8,8,1,10,2,7,1
M507,30,15,8,7,0,15,5,9,1
M504,33,17,13,1,3,16,5,9,2
M505,26,11,6,5,0,15,3,9,3
M502,28,14,10,3,1,14,4,7,3
M503,33,23,13,6,4,10,3,5,2
M508,29,6,4,2,0,23,5,14,4
M509,32,21,11,10,0,11,4,7,0
C827,30,18,12,4,2,12,3,7,2
C826,28,20,11,8,1,8,2,5,1
C825,28,9,7,1,1,19,8,11,0
C824,25,11,9,2,0,14,7,7,0
C822,29,22,13,6,3,7,0,7,0
C821,27,24,12,11,1,3,0,3,0
C820,25,15,7,8,0,10,4,6,0
C829,29,12,8,3,1,17,6,10,1
C828,26,15,10,5,0,11,3,8,0
Q658,32,20,9,9,2,12,4,7,1
Q659,32,14,10,2,2,18,4,12,2
Q652,29,17,8,9,0,12,8,3,1
Q653,32,24,10,11,3,8,2,6,0
Q650,32,16,9,4,3,16,4,10,2
Q651,35,26,16,6,4,9,4,5,0
Q657,28,11,6,5,0,17,6,10,1
Q654,29,6,3,3,0,23,9,14,0
Q655,32,18,11,4,3,14,4,8,2
C537,25,4,3,1,0,21,7,13,1
E509,28,10,8,1,1,18,4,13,1
E506,24,10,5,5,0,14,5,7,2
E507,25,9,5,4,0,16,4,11,1
J668,28,16,11,5,0,12,6,5,1
J669,28,18,12,5,1,10,0,8,2
J666,34,19,13,5,1,15,7,5,3
J667,26,14,8,6,0,12,4,7,1
J664,24,9,6,3,0,15,4,11,0
J665,28,2,1,1,0,26,11,14,1
J662,28,16,12,2,2,12,3,7,2
J663,28,16,12,4,0,12,5,5,2
J660,30,18,14,4,0,12,6,5,1
J661,28,6,4,1,1,22,8,13,1
D839,29,16,12,3,1,13,3,8,2
D838,27,9,5,3,1,18,6,11,1
D529,27,17,11,5,1,10,2,7,1
D528,27,9,4,4,1,18,8,7,3
D831,28,13,8,4,1,15,6,8,1
D830,30,14,9,3,2,16,6,8,2
D833,25,4,1,1,2,21,7,12,2
D832,24,9,5,4,0,15,5,9,1
D835,29,13,6,5,2,16,5,10,1
D834,26,14,10,2,2,12,2,10,0
D521,29,5,5,0,0,24,10,11,3
D520,26,15,9,5,1,11,3,8,0
L527,31,20,14,5,1,11,4,6,1
L526,30,16,12,3,1,14,2,11,1
D749,27,15,11,3,1,12,3,8,1
L524,29,13,7,5,1,16,6,9,1
L523,28,7,4,3,0,21,7,13,1
L522,31,22,9,10,3,9,3,6,0
L521,30,14,12,0,2,16,5,10,1
L520,31,9,7,2,0,22,7,11,4
D743,27,15,11,3,1,12,1,10,1
D742,26,16,11,2,3,10,1,7,2
D741,32,20,9,8,3,12,5,7,0
D740,26,18,10,7,1,8,2,4,2
D747,28,16,8,6,2,12,1,9,2
D746,30,18,12,5,1,12,4,7,1
L529,29,11,7,3,1,18,7,10,1
D744,28,12,8,2,2,16,3,12,1
K502,28,22,14,6,2,6,0,5,1
K503,30,21,12,6,3,9,0,7,2
K504,29,17,14,3,0,12,4,7,1
K505,23,11,7,4,0,12,2,9,1
K506,30,12,7,4,1,18,4,12,2
K507,31,21,10,8,3,10,3,7,0
K508,28,8,5,3,0,20,4,15,1
K509,29,12,7,4,1,17,4,12,1
H639,29,20,8,9,3,9,4,4,1
H637,30,13,11,1,1,17,5,9,3
H636,30,23,13,7,3,7,1,2,4
H635,29,12,7,4,1,17,6,8,3
H634,29,19,10,7,2,10,1,7,2
H633,28,12,8,3,1,16,3,9,4
H632,28,10,8,2,0,18,2,16,0
H631,32,19,8,7,4,13,3,8,2
H630,29,9,6,3,0,20,3,15,2
P637,31,21,15,5,1,10,1,5,4
P636,34,32,16,9,7,2,1,1,0
P635,32,21,11,10,0,11,4,6,1
P634,29,4,1,2,1,25,9,15,1
P633,29,18,10,8,0,11,2,8,1
P632,30,15,7,7,1,15,3,11,1
P631,31,17,7,7,3,14,2,9,3
P630,29,17,10,7,0,12,3,8,1
P639,33,22,13,5,4,11,2,8,1
P638,30,7,5,2,0,23,8,14,1
N798,31,6,6,0,0,25,7,17,1
N799,34,12,6,4,2,22,8,12,2
N796,32,13,11,0,2,19,6,11,2
N797,29,20,10,9,1,9,3,5,1
N794,32,23,16,5,2,9,2,5,2
N795,26,10,7,2,1,16,4,10,2
N792,28,10,6,4,0,18,7,11,0
N793,33,22,13,4,5,11,2,6,3
N790,33,21,10,6,5,12,5,5,2
N791,28,11,7,4,0,17,5,12,0
R798,28,15,8,6,1,13,4,9,0
R799,30,17,6,9,2,13,5,8,0
R792,27,10,7,3,0,17,5,12,0
R793,32,16,12,2,2,16,4,8,4
R790,32,20,13,4,3,12,3,7,2
R791,30,16,9,5,2,14,2,10,2
R796,31,11,9,1,1,20,11,8,1
R797,28,7,5,2,0,21,7,13,1
R794,33,18,12,4,2,15,6,6,3
R795,33,11,3,5,3,22,11,8,3
F699,27,9,8,1,0,18,5,12,1
F698,29,13,7,3,3,16,6,10,0
F693,29,12,7,2,3,17,4,11,2
F692,29,17,9,8,0,12,3,9,0
F690,27,4,3,1,0,23,9,12,2
F695,29,13,11,2,0,16,6,8,2
K690,27,16,9,6,1,11,3,6,2
K692,26,8,4,3,1,18,8,10,0
K693,29,6,4,2,0,23,6,16,1
K695,30,21,15,5,1,9,3,5,1
K698,32,19,14,3,2,13,5,6,2
K699,31,26,16,10,0,5,1,3,1
L738,32,21,16,2,3,11,1,8,2
L739,28,13,8,5,0,15,5,10,0
L732,31,8,7,1,0,23,8,13,2
L733,30,17,10,6,1,13,3,9,1
L730,30,8,3,3,2,22,8,12,2
L731,34,27,16,8,3,7,2,3,2
L736,28,11,5,3,3,17,6,9,2
L737,30,18,16,2,0,12,3,7,2
L734,28,6,4,2,0,22,5,15,2
G838,28,19,11,8,0,9,1,7,1
G839,32,20,13,5,2,12,3,7,2
G830,28,17,13,3,1,11,3,7,1
G831,28,10,9,1,0,18,6,10,2
G832,25,7,4,3,0,18,5,11,2
G833,24,8,2,6,0,16,7,8,1
G834,26,10,7,3,0,16,7,8,1
G835,29,26,12,10,4,3,0,3,0
G836,30,17,10,6,1,13,4,8,1
I601,27,7,3,3,1,20,7,13,0
I600,26,18,8,8,2,8,2,5,1
I603,28,13,10,3,0,15,6,8,1
I602,30,21,12,7,2,9,1,7,1
I605,27,18,8,8,2,9,3,5,1
I604,29,16,13,1,2,13,3,9,1
I607,29,27,13,11,3,2,0,0,2
I606,32,23,12,7,4,9,3,5,1
I608,27,9,4,5,0,18,5,11,2
J851,30,15,11,4,0,15,4,10,1
J850,24,10,6,4,0,14,3,10,1
J853,29,17,12,4,1,12,4,7,1
J852,28,15,11,3,1,13,3,8,2
J855,26,3,3,0,0,23,10,12,1
J854,27,11,7,3,1,16,4,10,2
P828,31,23,12,10,1,8,2,4,2
P829,32,21,13,7,1,11,4,5,2
P822,32,29,16,11,2,3,0,3,0
P823,26,15,9,6,0,11,3,8,0
P820,29,16,8,5,3,13,3,10,0
P821,30,12,8,4,0,18,6,9,3
P826,32,21,11,6,4,11,3,8,0
P827,33,23,14,5,4,10,3,5,2
P824,33,24,18,5,1,9,3,5,1
P825,34,23,11,8,4,11,3,6,2
G559,30,24,13,7,4,6,2,3,1
G558,26,10,4,4,2,16,6,9,1
G553,28,8,6,2,0,20,6,13,1
G552,28,12,9,3,0,16,7,9,0
G551,30,13,8,3,2,17,8,7,2
G550,25,13,9,3,1,12,2,8,2
G557,29,11,6,3,2,18,7,9,2
G556,28,14,11,2,1,14,4,9,1
G555,26,15,7,8,0,11,4,6,1
G554,28,20,10,6,4,8,3,4,1
C809,26,15,7,8,0,11,5,6,0
C805,31,20,11,7,2,11,4,5,2
C804,31,15,9,5,1,16,5,9,2
C807,25,7,5,2,0,18,8,10,0
C801,29,7,5,2,0,22,9,11,2
C800,25,6,4,2,0,19,6,12,1
C803,27,3,3,0,0,24,8,16,0
C802,30,18,11,5,2,12,4,6,2
Q630,29,10,7,3,0,19,5,13,1
Q631,30,12,9,3,0,18,5,12,1
Q632,30,6,3,2,1,24,7,16,1
Q633,30,8,5,3,0,22,6,15,1
Q634,30,13,7,4,2,17,4,10,3
Q635,32,12,5,5,2,20,9,9,2
Q636,33,27,16,8,3,6,0,2,4
Q637,31,21,11,6,4,10,4,4,2
Q638,30,2,0,1,1,28,11,16,1
Q639,31,20,11,7,2,11,3,6,2
D505,25,8,6,2,0,17,4,13,0
D504,31,17,11,3,3,14,3,9,2
D506,25,9,6,3,0,16,6,10,0
D503,26,17,9,8,0,9,3,6,0
D502,23,7,5,1,1,16,7,9,0
D509,26,5,1,3,1,21,10,10,1
D508,28,22,11,10,1,6,0,6,0
D761,24,4,4,0,0,20,7,12,1
D762,27,18,8,9,1,9,3,4,2
D765,25,3,1,2,0,22,10,12,0
D764,28,14,12,2,0,14,4,10,0
D767,28,14,7,6,1,14,6,6,2
D766,30,25,12,9,4,5,1,4,0
D769,29,8,7,0,1,21,7,11,3
D768,27,11,10,1,0,16,2,11,3
L509,30,16,10,6,0,14,3,11,0
L508,29,10,7,3,0,19,3,12,4
L505,26,6,5,0,1,20,5,13,2
L504,31,20,14,2,4,11,2,8,1
L507,32,23,11,11,1,9,2,7,0
L506,29,9,6,3,0,20,5,11,4
L503,32,25,12,10,3,7,1,4,2
L502,30,22,13,6,3,8,1,5,2
O519,30,15,9,5,1,15,4,9,2
O518,31,14,11,1,2,17,5,9,3
O517,28,13,9,4,0,15,4,11,0
O516,29,15,8,5,2,14,5,8,1
O515,32,14,12,2,0,18,8,7,3
K525,26,17,9,6,2,9,2,7,0
O513,28,6,6,0,0,22,6,14,2
O512,32,22,16,5,1,10,3,5,2
O511,31,16,11,4,1,15,5,7,3
K521,17,4,4,0,0,13,4,8,1
H615,29,8,5,2,1,21,8,11,2
H614,27,7,4,2,1,20,6,12,2
H617,28,8,6,1,1,20,7,11,2
H616,29,25,11,10,4,4,0,3,1
H611,28,15,10,4,1,13,1,9,3
H610,30,19,10,7,2,11,4,6,1
H613,29,18,15,2,1,11,1,10,0
H612,26,11,5,6,0,15,7,7,1
H619,30,13,5,5,3,17,6,10,1
G788,29,14,11,2,1,15,6,7,2
G789,29,15,9,5,1,14,4,5,5
G786,31,20,13,5,2,11,4,6,1
G787,25,10,7,3,0,15,5,10,0
G784,25,9,6,3,0,16,5,11,0
G785,28,6,3,3,0,22,6,13,3
G782,28,4,0,3,1,24,9,14,1
G783,28,19,10,7,2,9,3,3,3
G780,31,15,10,3,2,16,6,8,2
G781,28,8,4,2,2,20,8,11,1
P619,30,6,6,0,0,24,9,13,2
P618,29,5,4,0,1,24,7,14,3
P615,31,20,9,10,1,11,3,4,4
P614,29,10,7,3,0,19,5,13,1
P617,28,10,8,2,0,18,6,11,1
P616,29,8,4,4,0,21,9,12,0
P611,31,11,8,3,0,20,6,13,1
P610,31,23,8,8,7,8,3,5,0
P613,29,17,12,4,1,12,4,6,2
P612,27,21,12,9,0,6,0,5,1
Q853,33,21,13,5,3,12,3,7,2
E719,33,20,11,5,4,13,2,8,3
E718,29,12,6,6,0,17,6,9,2
E717,32,18,13,4,1,14,4,7,3
E716,28,15,9,5,1,13,3,10,0
E715,30,5,5,0,0,25,12,9,4
E714,29,14,10,2,2,15,4,10,1
E713,28,18,10,5,3,10,2,8,0
E712,28,7,4,3,0,21,8,12,1
E711,27,7,5,1,1,20,7,12,1
M717,31,24,17,5,2,7,0,4,3
M716,30,13,7,4,2,17,4,10,3
M715,29,7,4,3,0,22,11,10,1
M714,31,17,10,6,1,14,6,7,1
M713,30,19,11,6,2,11,3,7,1
M712,31,14,7,6,1,17,3,13,1
M711,28,17,13,4,0,11,2,8,1
M710,28,2,2,0,0,26,9,16,1
M719,31,19,12,5,2,12,1,8,3
M718,29,15,8,5,2,14,4,9,1
M849,33,29,16,10,3,4,2,2,0
M848,31,20,10,6,4,11,3,6,2
M847,32,16,8,5,3,16,5,10,1
M846,31,11,8,2,1,20,7,10,3
M845,29,13,8,5,0,16,8,8,0
M844,30,15,11,3,1,15,3,12,0
M843,33,23,12,6,5,10,2,5,3
M842,28,15,11,4,0,13,2,9,2
M841,32,24,9,10,5,8,4,3,1
M840,32,16,12,4,0,16,6,7,3
L750,32,18,11,6,1,14,2,11,1
L751,28,18,8,8,2,10,2,7,1
L752,31,15,8,6,1,16,4,10,2
L753,29,15,6,6,3,14,5,8,1
L754,29,19,13,5,1,10,2,6,2
L755,30,12,6,5,1,18,5,10,3
L756,30,5,4,1,0,25,7,16,2
L757,28,17,7,10,0,11,6,4,1
L758,30,20,11,7,2,10,4,5,1
L759,26,8,7,1,0,18,3,13,2
G816,31,22,11,8,3,9,2,7,0
G817,30,20,16,4,0,10,3,7,0
G814,26,12,7,5,0,14,3,10,1
G815,30,20,11,6,3,10,1,8,1
G812,31,19,11,5,3,12,0,9,3
G813,29,20,9,8,3,9,2,7,0
G810,30,19,11,5,3,11,4,5,2
G811,29,19,11,5,3,10,1,7,2
G818,31,22,11,9,2,9,3,5,1
G819,26,11,7,4,0,15,5,10,0
G840,28,10,6,3,1,18,6,10,2
C648,28,18,10,8,0,10,1,8,1
C647,29,10,7,1,2,19,7,10,2
C645,27,10,5,5,0,17,7,10,0
C644,25,8,4,4,0,17,5,12,0
C643,29,15,9,6,0,14,5,9,0
C642,26,17,8,8,1,9,1,8,0
C641,27,9,6,2,1,18,4,9,5
C640,33,29,10,12,7,4,3,0,1
D527,27,6,5,0,1,21,9,10,2
D526,28,20,8,9,3,8,3,4,1
D523,27,11,6,5,0,16,8,7,1
D522,25,12,6,6,0,13,3,10,0
P840,33,23,14,5,4,10,2,6,2
P841,31,19,10,5,4,12,4,6,2
P842,28,15,9,5,1,13,2,9,2
P843,31,20,12,5,3,11,2,6,3
P844,31,13,9,4,0,18,4,12,2
P845,32,19,10,8,1,13,5,7,1
P846,31,23,12,8,3,8,4,2,2
P847,31,9,6,2,1,22,8,13,1
P848,28,11,7,4,0,17,4,10,3
P849,31,23,16,5,2,8,0,6,2
D836,26,11,8,1,2,15,4,11,0
O845,32,18,8,7,3,14,4,8,2
O844,31,19,10,8,1,12,4,6,2
O847,31,21,9,10,2,10,3,6,1
O846,33,24,16,5,3,9,0,7,2
O841,30,15,8,2,5,15,5,9,1
O840,33,24,17,4,3,9,2,6,1
O843,33,27,12,7,8,6,2,4,0
O842,28,18,11,5,2,10,2,8,0
O849,31,23,16,5,2,8,1,5,2
O848,30,17,10,6,1,13,2,11,0
G571,29,16,7,8,1,13,3,9,1
G570,30,14,8,4,2,16,4,9,3
G573,28,9,6,3,0,19,10,9,0
G572,27,7,5,2,0,20,7,12,1
I818,28,13,7,6,0,15,7,6,2
I819,26,14,9,5,0,12,2,8,2
G577,32,29,13,7,9,3,0,3,0
G576,28,14,10,4,0,14,2,9,3
I814,27,7,3,4,0,20,8,12,0
I815,27,10,6,4,0,17,6,11,0
I816,30,15,9,4,2,15,3,10,2
I817,29,17,11,4,2,12,4,7,1
I810,28,11,9,1,1,17,6,9,2
I811,26,18,9,6,3,8,1,7,0
I812,28,9,6,3,0,19,4,13,2
I813,28,7,2,4,1,21,9,11,1
Q618,27,7,6,0,1,20,5,13,2
Q619,30,9,5,3,1,21,5,14,2
Q616,29,15,10,4,1,14,3,11,0
Q617,29,14,12,1,1,15,5,8,2
Q614,29,11,8,3,0,18,6,12,0
Q615,32,10,8,1,1,22,9,11,2
Q612,29,25,10,12,3,4,1,3,0
Q613,30,14,9,3,2,16,7,7,2
Q610,33,12,6,1,5,21,5,13,3
Q611,31,9,5,4,0,22,9,12,1
D562,29,21,12,8,1,8,2,6,0
D561,25,10,4,5,1,15,7,7,1
D560,29,15,7,7,1,14,2,10,2
D567,25,13,7,6,0,12,5,7,0
D566,26,3,3,0,0,23,10,13,0
D565,27,15,7,6,2,12,3,8,1
D564,26,12,9,3,0,14,3,10,1
D569,28,11,9,1,1,17,6,9,2
D568,25,14,7,6,1,11,3,5,3
R734,31,12,6,3,3,19,4,13,2
R735,29,5,4,1,0,24,6,15,3
D789,31,21,13,6,2,10,2,8,0
D788,28,18,12,6,0,10,3,6,1
D786,31,20,9,7,4,11,7,4,0
D784,25,12,7,5,0,13,4,8,1
D783,30,24,13,11,0,6,2,3,1
D782,29,14,4,9,1,15,8,6,1
D781,30,12,6,3,3,18,5,9,4
D780,31,15,12,1,2,16,3,10,3
L569,31,19,15,2,2,12,2,9,1
L568,31,27,11,10,6,4,1,3,0
D745,26,14,9,5,0,12,3,8,1
L562,32,22,12,5,5,10,2,8,0
L561,27,15,7,7,1,12,5,7,0
L560,32,12,7,3,2,20,3,16,1
L567,27,9,6,3,0,18,7,11,0
L566,27,8,6,2,0,19,5,14,0
L565,29,12,8,2,2,17,5,11,1
L564,28,18,10,7,1,10,2,7,1
O535,32,28,15,12,1,4,0,1,3
O534,29,17,8,8,1,12,4,6,2
O537,29,14,9,5,0,15,3,11,1
O536,33,28,14,10,4,5,1,4,0
O531,29,9,3,6,0,20,9,10,1
O530,31,16,10,4,2,15,5,8,2
O533,31,14,8,5,1,17,5,11,1
O532,30,1,0,1,0,29,11,16,2
R738,32,15,11,4,0,17,6,7,4
O539,33,23,15,6,2,10,1,6,3
O538,31,12,6,5,1,19,6,12,1
R739,31,15,8,6,1,16,6,8,2
B604,32,24,13,6,5,8,2,5,1
B605,25,8,5,3,0,17,5,12,0
B606,27,9,8,0,1,18,6,12,0
B607,25,13,9,4,0,12,3,9,0
B600,26,8,7,1,0,18,5,13,0
B602,27,10,9,1,0,17,6,11,0
B603,28,19,10,7,2,9,3,4,2
B608,25,9,5,4,0,16,4,10,2
H673,28,16,14,2,0,12,3,8,1
H672,28,14,7,4,3,14,5,9,0
H671,31,19,14,3,2,12,2,6,4
H670,30,17,12,5,0,13,4,5,4
H677,29,9,4,4,1,20,8,8,4
H676,31,21,14,3,4,10,1,7,2
H675,30,21,12,4,5,9,2,6,1
H674,29,14,10,3,1,15,6,8,1
H679,28,15,6,9,0,13,6,5,2
H678,29,17,9,7,1,12,6,5,1
I555,27,13,7,5,1,14,4,9,1
I554,28,19,11,7,1,9,1,7,1
P679,30,9,5,2,2,21,10,11,0
P678,33,25,15,7,3,8,1,6,1
P673,31,17,11,3,3,14,6,7,1
P672,31,15,9,4,2,16,4,10,2
P671,32,18,12,2,4,14,3,8,3
P670,32,19,13,5,1,13,5,5,3
P677,29,15,10,5,0,14,4,9,1
P676,32,22,16,2,4,10,1,7,2
P675,31,17,12,4,1,14,5,5,4
P674,33,20,13,4,3,13,4,7,2
E734,26,6,3,2,1,20,6,13,1
E737,29,10,7,3,0,19,9,7,3
E736,28,18,10,7,1,10,2,5,3
E731,28,13,9,3,1,15,7,7,1
E730,32,24,11,10,3,8,1,5,2
E733,27,13,7,5,1,14,5,7,2
E732,26,8,7,1,0,18,5,12,1
E739,27,17,9,7,1,10,3,7,0
E738,29,20,12,7,1,9,2,4,3
N644,29,15,8,7,0,14,6,8,0
N645,29,18,10,6,2,11,2,8,1
N646,30,16,11,5,0,14,4,10,0
N647,30,15,9,6,0,15,5,9,1
N640,33,20,12,4,4,13,6,6,1
N641,31,18,10,6,2,13,6,4,3
N642,30,8,6,2,0,22,8,14,0
N643,26,11,5,5,1,15,5,9,1
N648,30,16,12,4,0,14,3,11,0
N649,27,13,9,3,1,14,2,11,1
M739,30,15,7,8,0,15,7,8,0
M738,32,24,16,6,2,8,1,5,2
M735,27,2,2,0,0,25,0,23,2
M734,29,7,4,3,0,22,7,15,0
M737,31,15,10,2,3,16,5,8,3
M736,27,5,5,0,0,22,7,13,2
M731,35,26,16,5,5,9,2,7,0
M730,31,10,3,5,2,21,6,13,2
M733,30,21,9,8,4,9,1,7,1
M732,30,8,4,2,2,22,8,12,2
L778,31,16,14,2,0,15,8,7,0
L779,31,17,9,6,2,14,4,7,3
L776,31,9,5,4,0,22,7,13,2
L777,28,7,5,2,0,21,9,12,0
L774,28,14,10,4,0,14,2,11,1
L775,29,7,3,3,1,22,11,10,1
L772,27,16,12,3,1,11,2,7,2
L773,31,10,6,4,0,21,6,12,3
L771,30,12,9,2,1,18,7,10,1
F659,30,17,13,3,1,13,2,10,1
F658,29,14,9,5,0,15,3,9,3
F657,28,17,9,7,1,11,2,8,1
F655,29,13,10,2,1,16,7,8,1
F654,28,7,7,0,0,21,8,12,1
F653,29,6,4,0,2,23,7,15,1
F652,27,8,4,4,0,19,7,11,1
F651,31,12,6,5,1,19,10,7,2
F650,28,16,8,7,1,12,3,7,2
H576,29,18,6,10,2,11,4,5,2
M788,29,13,12,1,0,16,4,12,0
M789,33,21,10,7,4,12,4,5,3
Q551,31,16,11,4,1,15,5,8,2
Q550,28,4,2,1,1,24,10,12,2
H578,30,9,5,3,1,21,8,11,2
Q805,31,15,8,6,1,16,7,8,1
H579,28,13,9,4,0,15,2,12,1
Q552,31,21,9,11,1,10,4,4,2
Q555,30,8,5,3,0,22,8,14,0
Q802,31,17,10,6,1,14,5,6,3
Q801,29,13,11,2,0,16,5,10,1
J729,29,6,3,1,2,23,10,9,4
J728,28,20,12,8,0,8,1,7,0
J727,29,26,12,13,1,3,1,1,1
J726,31,17,12,2,3,14,1,10,3
J725,27,14,9,3,2,13,5,7,1
J724,31,24,10,11,3,7,1,4,2
J723,32,27,14,10,3,5,1,4,0
J722,29,23,12,7,4,6,1,4,1
J721,31,24,14,6,4,7,1,3,3
J720,32,20,15,2,3,12,2,8,2
C665,27,9,7,2,0,18,5,13,0
C664,25,6,4,2,0,19,8,11,0
C667,24,3,3,0,0,21,8,13,0
C666,27,16,10,6,0,11,4,6,1
C661,25,9,7,2,0,16,4,11,1
C660,28,18,11,6,1,10,5,4,1
C663,31,21,8,8,5,10,2,6,2
C662,29,19,14,4,1,10,2,7,1
C669,28,16,9,5,2,12,3,8,1
C668,27,18,11,7,0,9,3,5,1
C593,28,11,8,3,0,17,5,12,0
C592,28,14,11,2,1,14,4,8,2
C590,26,5,3,2,0,21,8,13,0
C597,27,16,10,5,1,11,4,6,1
C596,27,6,4,1,1,21,7,13,1
C595,30,17,9,6,2,13,5,7,1
C594,29,21,15,6,0,8,0,8,0
C599,32,24,13,8,3,8,2,4,2
C598,27,8,6,2,0,19,7,11,1
O823,26,8,7,0,1,18,4,12,2
O822,33,26,16,8,2,7,1,5,1
O821,31,14,9,4,1,17,8,8,1
O820,27,16,8,6,2,11,3,7,1
O827,31,23,14,7,2,8,2,3,3
O826,29,12,7,5,0,17,4,12,1
O825,31,22,15,5,2,9,1,7,1
O824,32,26,15,8,3,6,2,2,2
O829,31,24,12,6,6,7,2,4,1
O828,34,25,10,12,3,9,2,6,1
H798,29,13,8,4,1,16,4,10,2
H799,28,4,3,1,0,24,9,13,2
H790,28,17,11,5,1,11,4,6,1
H791,25,1,0,1,0,24,10,14,0
H792,29,17,10,5,2,12,1,9,2
H793,28,22,14,5,3,6,0,4,2
H794,28,14,10,2,2,14,4,8,2
H795,27,15,11,4,0,12,2,10,0
H796,30,18,10,6,2,12,4,6,2
H797,24,10,5,5,0,14,4,10,0
E692,27,21,13,7,1,6,2,4,0
C840,27,18,12,6,0,9,2,7,0
C843,28,20,12,5,3,8,1,6,1
C842,26,13,9,4,0,13,3,9,1
C845,27,3,2,1,0,24,10,14,0
C844,28,16,12,4,0,12,4,8,0
C847,26,19,11,7,1,7,1,5,1
C846,31,16,10,5,1,15,5,7,3
C849,31,12,7,2,3,19,8,10,1
C848,24,5,2,3,0,19,8,11,0
E698,30,11,10,0,1,19,6,9,4
E699,28,8,6,2,0,20,8,12,0
I838,28,12,5,6,1,16,7,9,0
I839,28,19,12,5,2,9,3,5,1
G599,28,12,7,3,2,16,5,8,3
G598,27,13,7,3,3,14,4,9,1
G597,33,19,12,5,2,14,4,8,2
G596,28,8,6,2,0,20,5,12,3
G595,29,12,10,1,1,17,6,10,1
G594,29,9,7,1,1,20,6,11,3
G593,28,9,6,3,0,19,3,15,1
G592,30,22,13,6,3,8,2,4,2
I834,27,3,3,0,0,24,9,14,1
G590,29,18,9,6,3,11,3,8,0
D549,31,26,14,7,5,5,0,4,1
D548,27,3,2,1,0,24,7,15,2
D541,27,15,9,5,1,12,3,8,1
D540,26,8,6,2,0,18,5,12,1
D543,28,14,8,4,2,14,2,10,2
D545,25,9,6,2,1,16,4,11,1
D544,31,19,10,7,2,12,5,5,2
D547,26,14,8,5,1,12,4,7,1
D546,32,22,11,6,5,10,2,7,1
B594,29,16,9,7,0,13,4,9,0
B595,27,16,12,3,1,11,3,8,0
B596,27,6,4,2,0,21,9,11,1
B597,30,19,12,6,1,11,0,7,4
B590,25,14,9,5,0,11,2,9,0
B592,29,12,8,3,1,17,6,6,5
B593,27,8,8,0,0,19,3,16,0
B598,25,8,5,3,0,17,6,11,0
B599,28,15,10,4,1,13,4,8,1
L541,31,12,4,7,1,19,9,9,1
L540,29,12,10,1,1,17,3,13,1
L543,31,10,8,1,1,21,5,13,3
L542,26,6,3,2,1,20,6,12,2
L545,26,4,4,0,0,22,5,15,2
L544,33,22,13,9,0,11,4,4,3
L547,30,12,6,4,2,18,7,8,3
L546,30,14,10,2,2,16,4,10,2
L549,30,11,10,0,1,19,8,9,2
L548,27,7,1,4,2,20,3,16,1
O553,30,24,13,9,2,6,2,3,1
O552,31,14,11,3,0,17,5,9,3
O551,31,21,14,5,2,10,2,6,2
O550,30,14,6,5,3,16,6,8,2
O557,30,15,10,3,2,15,4,10,1
O556,29,13,12,1,0,16,3,10,3
O555,29,10,7,3,0,19,6,11,2
O554,32,21,12,7,2,11,1,8,2
O559,32,17,14,2,1,15,4,9,2
O558,28,11,7,4,0,17,6,11,0
B622,29,15,11,4,0,14,3,11,0
B623,30,21,13,5,3,9,2,6,1
B620,25,8,6,2,0,17,4,11,2
B621,26,13,10,3,0,13,4,9,0
B626,28,12,7,4,1,16,6,9,1
B627,29,22,12,10,0,7,2,5,0
B624,29,24,11,9,4,5,1,4,0
B625,32,22,15,5,2,10,3,7,0
B628,29,20,14,5,1,9,2,5,2
B629,28,20,14,5,1,8,3,5,0
I582,28,16,10,6,0,12,1,9,2
I583,26,12,9,2,1,14,5,8,1
I580,27,12,9,3,0,15,3,11,1
I581,25,10,5,5,0,15,5,9,1
I586,29,24,10,11,3,5,0,3,2
I587,29,7,4,2,1,22,8,13,1
I585,28,10,9,1,0,18,3,12,3
I588,28,16,9,7,0,12,3,8,1
I589,30,19,8,9,2,11,3,7,1
H659,29,13,6,5,2,16,7,7,2
H658,29,23,7,12,4,6,2,3,1
H651,30,24,16,8,0,6,2,3,1
H650,25,10,7,3,0,15,4,10,1
H653,28,4,3,1,0,24,11,11,2
H652,30,11,7,1,3,19,5,10,4
H655,31,21,16,2,3,10,2,6,2
H654,31,15,10,5,0,16,2,11,3
H657,28,12,8,3,1,16,3,9,4
P651,34,25,19,4,2,9,2,6,1
P650,31,11,7,2,2,20,6,14,0
P653,30,15,8,7,0,15,6,8,1
P652,30,9,6,2,1,21,7,12,2
P655,32,11,8,3,0,21,10,8,3
P654,31,16,9,7,0,15,8,7,0
P657,29,14,6,8,0,15,7,8,0
P659,33,6,4,1,1,27,10,15,2
P658,31,6,3,3,0,25,10,11,4
E753,28,19,10,7,2,9,2,5,2
E752,30,20,9,6,5,10,2,6,2
E751,27,20,9,9,2,7,1,6,0
E750,28,3,3,0,0,25,11,14,0
E757,26,12,7,5,0,14,5,9,0
E756,26,11,7,3,1,15,4,9,2
E755,27,18,10,8,0,9,4,5,0
E754,27,4,4,0,0,23,10,13,0
E758,30,18,10,7,1,12,4,6,2
N662,33,20,14,2,4,13,4,6,3
N663,29,11,6,3,2,18,7,10,1
N660,33,24,16,7,1,9,2,4,3
N661,29,12,10,2,0,17,3,9,5
N666,34,31,19,10,2,3,1,1,1
N667,31,16,7,7,2,15,4,10,1
N664,27,9,7,2,0,18,5,13,0
N665,30,7,5,2,0,23,6,16,1
N668,29,17,11,4,2,12,4,6,2
N669,30,17,9,7,1,13,2,10,1
M759,27,10,5,4,1,17,3,13,1
M758,29,13,6,6,1,16,6,9,1
M753,33,20,12,7,1,13,5,6,2
M752,28,12,5,7,0,16,7,9,0
M751,27,19,10,8,1,8,2,5,1
M750,32,18,9,9,0,14,6,8,0
M757,30,22,10,10,2,8,3,4,1
M756,32,13,7,4,2,19,6,11,2
M755,30,9,6,2,1,21,7,13,1
M754,31,19,10,6,3,12,3,7,2
F675,28,16,13,2,1,12,3,8,1
F674,32,25,15,7,3,7,1,4,2
F677,30,14,9,5,0,16,5,9,2
F676,31,19,14,3,2,12,2,8,2
F671,28,24,17,7,0,4,0,3,1
F670,28,10,8,2,0,18,7,8,3
F673,29,16,11,4,1,13,5,6,2
F672,26,4,3,1,0,22,9,11,2
F679,30,21,10,8,3,9,2,7,0
F678,29,13,10,2,1,16,4,11,1
M803,27,14,4,6,4,13,3,6,4
M802,33,20,13,3,4,13,2,10,1
M801,31,16,9,4,3,15,6,8,1
M800,29,10,7,3,0,19,6,12,1
M807,33,17,11,3,3,16,2,10,4
M806,29,7,6,1,0,22,7,15,0
M805,32,22,14,7,1,10,1,5,4
M804,32,7,4,3,0,25,7,15,3
M809,31,16,12,3,1,15,4,8,3
M808,29,8,7,0,1,21,5,15,1
J705,24,3,3,0,0,21,7,14,0
J704,29,20,13,5,2,9,0,9,0
J707,27,13,6,7,0,14,4,9,1
J701,31,25,17,5,3,6,1,5,0
J700,27,8,5,3,0,19,6,12,1
J703,29,12,8,3,1,17,3,10,4
J702,28,4,1,1,2,24,11,11,2
J708,31,27,15,8,4,4,0,2,2
D686,29,15,7,5,3,14,4,10,0
D687,31,26,12,10,4,5,0,3,2
D685,26,13,8,4,1,13,3,8,2
D682,26,11,8,3,0,15,3,11,1
D683,28,14,7,5,2,14,2,11,1
D680,24,10,6,4,0,14,6,8,0
D681,26,13,9,3,1,13,2,10,1
K724,31,20,12,6,2,11,2,8,1
K725,32,14,9,3,2,18,7,9,2
K726,31,13,7,2,4,18,6,10,2
K727,29,22,10,9,3,7,3,4,0
K720,30,25,16,6,3,5,1,3,1
K721,28,20,14,6,0,8,1,5,2
K722,32,17,11,3,3,15,5,7,3
K723,30,21,13,6,2,9,1,6,2
K728,27,19,12,7,0,8,4,4,0
K729,29,15,11,3,1,14,6,7,1
C603,27,13,10,2,1,14,4,8,2
C602,27,9,4,4,1,18,8,10,0
C600,25,7,4,3,0,18,6,12,0
C607,30,21,11,7,3,9,2,7,0
C606,30,17,10,4,3,13,5,7,1
C605,26,14,10,4,0,12,3,9,0
C604,30,16,11,4,1,14,6,6,2
C608,25,14,9,4,1,11,2,9,0
A788,28,14,11,2,1,14,4,7,3
A789,31,19,10,6,3,12,4,8,0
O616,31,9,5,3,1,22,7,14,1
O617,33,18,10,3,5,15,5,9,1
O610,32,14,6,6,2,18,6,9,3
O611,30,8,5,3,0,22,8,13,1
O612,27,20,10,10,0,7,2,5,0
O613,29,9,9,0,0,20,11,9,0
A780,29,16,13,1,2,13,3,9,1
A781,27,12,6,6,0,15,7,7,1
A782,27,15,8,6,1,12,4,7,1
A783,27,19,13,5,1,8,1,7,0
A784,25,8,5,2,1,17,6,10,1
O619,32,7,4,2,1,25,5,15,5
A786,32,24,15,5,4,8,1,5,2
A526,26,14,8,5,1,12,3,6,3
A527,28,18,11,6,1,10,5,4,1
A520,28,16,10,5,1,12,3,8,1
A521,25,8,6,1,1,17,6,10,1
A523,23,8,5,2,1,15,2,12,1
A528,29,18,10,5,3,11,2,8,1
A529,25,12,7,4,1,13,3,10,0
O809,31,14,8,3,3,17,6,9,2
O808,27,10,6,4,0,17,6,11,0
M588,28,8,4,4,0,20,8,10,2
M589,30,14,7,7,0,16,6,9,1
O801,30,8,5,2,1,22,10,9,3
M587,29,8,6,2,0,21,8,12,1
O803,33,6,3,2,1,27,7,18,2
M585,31,13,7,3,3,18,5,12,1
M582,28,9,7,2,0,19,5,12,2
M583,27,9,7,1,1,18,9,8,1
M580,28,12,7,5,0,16,7,9,0
M581,31,14,10,3,1,17,4,11,2
G608,27,8,7,1,0,19,4,15,0
G607,31,28,12,11,5,3,0,2,1
G606,31,15,9,4,2,16,7,6,3
G605,29,19,10,7,2,10,3,5,2
G604,30,21,11,6,4,9,2,6,1
G603,29,18,11,6,1,11,5,4,2
G602,28,19,11,7,1,9,2,6,1
G601,21,13,7,5,1,8,0,8,0
G600,26,14,10,4,0,12,2,8,2
I850,26,6,3,3,0,20,6,13,1
I851,27,14,8,6,0,13,5,8,0
I852,28,11,10,0,1,17,5,11,1
I853,33,23,13,7,3,10,3,6,1
I854,26,11,6,3,2,15,4,10,1
I855,27,7,6,1,0,20,6,14,0
B828,26,13,9,4,0,13,4,9,0
B829,31,22,12,6,4,9,3,5,1
B824,23,10,8,1,1,13,4,9,0
B825,27,14,9,4,1,13,5,8,0
B826,28,22,13,9,0,6,2,4,0
B827,29,18,12,5,1,11,3,8,0
B820,24,7,6,1,0,17,5,12,0
B821,28,25,12,10,3,3,1,1,1
B822,26,17,11,5,1,9,2,6,1
O579,29,17,10,7,0,12,4,7,1
O578,30,15,11,3,1,15,3,11,1
O571,26,14,9,4,1,12,4,8,0
O570,31,7,5,2,0,24,10,12,2
O573,31,8,6,0,2,23,9,11,3
O572,32,19,15,2,2,13,1,11,1
O575,33,14,8,4,2,19,8,8,3
O574,33,19,10,6,3,14,5,8,1
O577,34,29,17,5,7,5,0,5,0
O576,32,16,10,6,0,16,4,11,1
B648,29,21,12,9,0,8,0,8,0
B640,33,29,14,10,5,4,1,2,1
B641,27,10,7,1,2,17,6,10,1
B642,26,9,5,4,0,17,5,11,1
B643,25,13,9,4,0,12,3,9,0
B644,27,1,1,0,0,26,10,16,0
B645,29,20,10,8,2,9,4,4,1
B647,27,13,9,3,1,14,3,10,1
L855,29,12,8,3,1,17,4,12,1
L854,26,13,7,6,0,13,5,8,0
L853,32,24,16,5,3,8,1,5,2
L852,31,16,11,2,3,15,2,9,4
L851,32,23,14,7,2,9,1,8,0
L850,27,7,4,3,0,20,5,14,1
E779,29,13,6,4,3,16,6,9,1
E778,31,24,16,8,0,7,1,5,1
E771,30,17,12,4,1,13,2,9,2
E773,27,16,8,6,2,11,2,8,1
E772,29,17,9,5,3,12,4,7,1
E775,30,21,11,6,4,9,2,7,0
E774,27,14,10,2,2,13,1,11,1
E777,28,10,7,3,0,18,6,11,1
E776,29,17,8,7,2,12,4,7,1
N608,28,5,3,1,1,23,8,14,1
N600,29,7,5,1,1,22,7,13,2
N601,27,10,4,6,0,17,5,12,0
N602,32,22,14,6,2,10,0,9,1
N603,30,16,11,3,2,14,5,8,1
N604,32,12,10,1,1,20,8,9,3
N605,30,10,5,4,1,20,8,10,2
N606,31,12,9,2,1,19,8,10,1
N607,30,25,10,9,6,5,2,1,2
M771,31,12,7,3,2,19,8,10,1
M773,28,10,6,4,0,18,4,12,2
M772,29,15,7,3,5,14,3,10,1
M775,30,8,5,1,2,22,8,14,0
M774,29,11,7,4,0,18,6,11,1
M777,28,5,2,3,0,23,12,11,0
M776,29,7,4,3,0,22,10,12,0
M779,33,21,8,9,4,12,5,6,1
M778,30,11,8,3,0,19,8,9,2
F613,30,17,13,2,2,13,5,8,0
F612,26,14,10,4,0,12,3,9,0
F611,28,4,2,1,1,24,11,12,1
F610,30,24,10,11,3,6,1,5,0
F617,29,9,6,1,2,20,7,11,2
F616,29,22,12,9,1,7,1,6,0
F615,30,26,11,11,4,4,1,2,1
F614,25,5,5,0,0,20,5,15,0
F619,28,10,6,4,0,18,4,12,2
R604,32,15,12,3,0,17,6,8,3
R605,30,14,8,6,0,16,7,9,0
R606,31,16,11,3,2,15,6,7,2
R607,32,30,14,10,6,2,1,1,0
R600,31,12,5,5,2,19,6,11,2
R601,30,18,9,6,3,12,2,9,1
R602,32,18,7,7,4,14,6,5,3
R603,31,25,16,6,3,6,1,3,2
R608,28,0,0,0,0,28,9,18,1
M829,32,20,12,4,4,12,3,7,2
M828,31,16,8,8,0,15,4,9,2
M821,30,16,10,4,2,14,4,9,1
M820,26,9,6,3,0,17,5,11,1
M823,27,13,7,5,1,14,3,11,0
M822,33,23,16,5,2,10,0,8,2
M825,31,24,12,9,3,7,1,3,3
M824,32,19,13,3,3,13,2,10,1
M827,33,26,19,4,3,7,0,6,1
M826,32,19,11,5,3,13,4,8,1
I681,25,12,8,2,2,13,5,7,1
I680,26,8,5,3,0,18,7,11,0
I683,27,11,8,2,1,16,2,11,3
I682,26,13,9,4,0,13,2,10,1
I685,27,21,11,7,3,6,1,4,1
I687,30,25,13,10,2,5,1,4,0
I686,29,10,6,4,0,19,6,11,2
J762,25,11,6,5,0,14,4,9,1
J761,27,19,9,8,2,8,1,6,1
J767,27,13,9,4,0,14,4,9,1
J766,30,6,3,3,0,24,10,10,4
J765,24,9,5,3,1,15,5,9,1
J764,28,12,9,3,0,16,7,8,1
J769,28,15,13,1,1,13,3,9,1
J768,25,7,4,3,0,18,7,10,1
D668,28,22,11,10,1,6,2,4,0
D669,29,22,12,7,3,7,0,6,1
D664,28,13,8,4,1,15,3,11,1
D665,27,10,6,3,1,17,4,12,1
D666,28,13,11,2,0,15,5,9,1
D667,25,7,4,3,0,18,6,11,1
D660,29,14,11,2,1,15,5,8,2
D661,25,14,9,5,0,11,2,8,1
D662,30,25,16,6,3,5,1,4,0
D663,30,14,9,3,2,16,5,10,1
K702,29,15,9,4,2,14,4,10,0
K703,27,8,6,1,1,19,3,13,3
K700,29,12,7,4,1,17,4,11,2
K701,30,17,15,2,0,13,2,9,2
K707,31,13,6,5,2,18,4,10,4
K704,29,11,6,3,2,18,6,10,2
K705,26,8,6,2,0,18,4,13,1
K708,29,22,13,8,1,7,4,2,1
L664,30,13,8,4,1,17,3,11,3
L665,30,3,0,2,1,27,11,14,2
L666,33,30,19,9,2,3,0,2,1
L667,28,11,7,4,0,17,5,11,1
L660,32,23,15,6,2,9,4,4,1
L661,32,13,9,3,1,19,5,10,4
L662,32,24,17,6,1,8,3,4,1
L663,31,23,11,9,3,8,2,5,1
L668,32,12,8,3,1,20,7,9,4
L669,32,18,11,3,4,14,2,11,1
H804,30,18,11,4,3,12,3,8,1
H805,30,18,10,3,5,12,4,8,0
H807,28,19,10,8,1,9,2,5,2
H800,30,25,9,12,4,5,1,3,1
H801,30,15,12,2,1,15,4,10,1
H802,31,22,14,6,2,9,3,6,0
H803,26,6,4,2,0,20,3,10,7
H808,23,5,3,2,0,18,7,11,0
H809,31,20,8,9,3,11,4,6,1
C629,29,11,9,1,1,18,6,10,2
C628,29,19,11,6,2,10,4,5,1
C621,25,5,4,1,0,20,9,10,1
C620,25,13,9,3,1,12,2,9,1
C623,31,22,15,6,1,9,2,4,3
C622,27,22,14,8,0,5,2,3,0
C625,30,19,12,5,2,11,3,7,1
C624,28,23,11,9,3,5,1,4,0
C627,31,26,15,11,0,5,0,3,2
C626,27,16,11,5,0,11,2,8,1
N855,28,9,5,4,0,19,9,10,0
N854,27,12,7,5,0,15,3,12,0
N851,33,20,11,5,4,13,4,9,0
N850,29,15,7,7,1,14,4,9,1
N853,32,25,14,7,4,7,1,4,2
N852,30,17,10,3,4,13,3,9,1
O632,30,18,8,9,1,12,3,7,2
O633,31,19,8,9,2,12,3,9,0
O630,29,14,8,5,1,15,4,10,1
O631,32,22,9,9,4,10,2,5,3
O636,34,32,18,9,5,2,0,2,0
O637,32,25,12,7,6,7,3,2,2
O634,28,9,8,1,0,19,7,12,0
O635,33,13,9,2,2,20,5,13,2
O638,31,11,6,3,2,20,6,12,2
O639,31,22,12,9,1,9,2,5,2
A502,24,2,2,0,0,22,9,10,3
A503,25,2,1,1,0,23,11,12,0
A506,24,7,4,2,1,17,6,5,6
A504,27,16,11,5,0,11,2,6,3
A508,23,8,5,3,0,15,4,9,2
A509,26,11,7,3,1,15,5,9,1
H758,27,12,7,5,0,15,7,7,1
H759,27,3,2,1,0,24,8,16,0
H754,27,14,9,5,0,13,6,7,0
H755,28,14,8,5,1,14,5,9,0
H756,26,5,3,2,0,21,8,12,1
H757,31,18,10,6,2,13,2,6,5
H750,28,7,4,3,0,21,8,11,2
H751,27,21,14,7,0,6,0,5,1
H752,27,12,8,4,0,15,3,11,1
H753,28,17,8,9,0,11,5,6,0
G625,30,19,10,6,3,11,1,6,4
G624,31,17,11,4,2,14,2,9,3
G627,30,13,5,5,3,17,6,8,3
G626,28,6,4,2,0,22,10,11,1
G621,25,8,5,1,2,17,4,12,1
G620,27,8,4,4,0,19,9,9,1
G623,32,24,13,5,6,8,1,5,2
G622,31,18,9,3,6,13,2,10,1
G629,31,12,11,0,1,19,6,10,3
G628,34,19,13,2,4,15,3,9,3
P754,32,30,12,12,6,2,1,1,0
P755,29,15,10,4,1,14,3,8,3
P756,31,16,8,6,2,15,6,8,1
P757,29,16,7,5,4,13,4,8,1
P750,29,11,5,6,0,18,7,10,1
P751,27,14,6,7,1,13,5,6,2
P752,29,10,4,5,1,19,8,9,2
P753,28,4,3,0,1,24,9,12,3
P758,31,17,11,5,1,14,5,6,3
P759,26,8,2,4,2,18,4,14,0
B809,24,5,3,2,0,19,9,10,0
B802,32,23,13,9,1,9,1,6,2
B803,26,1,1,0,0,25,9,16,0
B800,26,15,6,9,0,11,4,7,0
B801,29,19,12,7,0,10,2,4,4
B807,26,1,1,0,0,25,11,14,0
B804,26,10,8,2,0,16,2,14,0
B805,31,18,10,4,4,13,4,6,3
R725,34,26,17,6,3,8,2,5,1
L585,28,5,2,3,0,23,9,12,2
L587,31,14,10,4,0,17,5,11,1
L586,31,22,13,8,1,9,2,6,1
L581,32,13,8,3,2,19,6,9,4
L580,30,19,9,8,2,11,3,8,0
L583,27,3,2,1,0,24,9,14,1
L582,26,12,7,5,0,14,3,11,0
L589,32,13,7,5,1,19,8,10,1
L588,29,13,5,7,1,16,7,9,0
F554,28,21,12,6,3,7,0,5,2
F555,25,10,6,4,0,15,3,10,2
F556,29,14,8,5,1,15,7,6,2
F557,26,13,8,4,1,13,3,9,1
F550,24,12,8,3,1,12,2,9,1
F551,31,12,9,1,2,19,7,9,3
F552,32,19,11,6,2,13,2,8,3
F553,28,8,6,2,0,20,7,12,1
F558,25,10,8,2,0,15,3,12,0
F559,29,18,16,1,1,11,1,8,2
B666,30,16,11,4,1,14,4,7,3
B667,24,2,2,0,0,22,8,12,2
B664,28,16,11,5,0,12,2,10,0
B665,25,8,6,2,0,17,4,13,0
B662,31,21,13,5,3,10,3,6,1
B663,31,18,9,9,0,13,4,4,5
B660,30,22,12,6,4,8,4,4,0
B661,28,19,13,6,0,9,0,8,1
B668,28,16,12,4,0,12,3,8,1
B669,29,21,12,6,3,8,0,8,0
R729,31,10,8,1,1,21,9,8,4
R728,31,9,5,4,0,22,7,12,3
K517,25,3,0,3,0,22,11,11,0
O509,31,11,7,4,0,20,8,12,0
K519,31,17,11,4,2,14,2,12,0
K518,28,12,11,1,0,16,5,11,0
N598,28,4,4,0,0,24,7,16,1
N599,28,10,7,3,0,18,5,10,3
N590,32,6,5,0,1,26,7,18,1
N591,30,10,10,0,0,20,6,14,0
N592,33,23,16,2,5,10,1,7,2
N593,31,10,7,1,2,21,3,16,2
N594,31,12,9,3,0,19,6,12,1
N595,34,25,13,7,5,9,3,5,1
N596,28,3,2,1,0,25,13,11,1
N597,34,13,9,3,1,21,8,10,3
P695,31,15,11,1,3,16,5,9,2
P694,26,11,5,6,0,15,4,10,1
P690,29,8,5,3,0,21,8,13,0
P693,29,12,8,4,0,17,2,14,1
P692,30,10,5,4,1,20,7,11,2
P699,31,12,8,3,1,19,5,10,4
P698,31,19,17,1,1,12,2,7,3
N626,31,10,4,4,2,21,9,10,2
N627,31,12,5,5,2,19,6,10,3
N624,33,24,13,7,4,9,2,6,1
N625,30,5,5,0,0,25,10,11,4
N622,30,15,7,8,0,15,6,8,1
N623,33,24,14,5,5,9,3,5,1
N620,30,15,11,4,0,15,3,11,1
N621,31,12,10,2,0,19,4,14,1
N628,32,15,13,1,1,17,4,11,2
N629,32,15,13,2,0,17,6,10,1
H567,26,7,3,3,1,19,9,10,0
H566,28,11,5,5,1,17,6,11,0
H565,28,13,8,4,1,15,4,10,1
H564,29,10,6,4,0,19,6,10,3
H562,33,29,17,7,5,4,0,4,0
H561,26,8,4,4,0,18,7,11,0
H560,28,11,5,6,0,17,4,11,2
M797,31,15,6,8,1,16,6,9,1
M796,30,15,13,1,1,15,2,10,3
M795,26,10,4,5,1,16,7,8,1
M794,33,23,15,4,4,10,4,5,1
M793,33,27,16,7,4,6,1,3,2
M792,30,11,5,6,0,19,6,13,0
H569,29,24,17,7,0,5,1,4,0
H568,24,14,8,6,0,10,2,7,1
G580,24,4,4,0,0,20,6,14,0
F639,31,22,9,7,6,9,2,4,3
R595,33,18,10,3,5,15,7,7,1
R596,31,7,4,1,2,24,7,15,2
R597,28,9,4,5,0,19,8,10,1
R590,31,13,9,3,1,18,4,13,1
R591,32,22,13,7,2,10,1,9,0
R592,33,26,15,7,4,7,0,5,2
R593,29,6,4,1,1,23,4,17,2
F631,27,9,5,3,1,18,6,11,1
F633,27,17,11,6,0,10,2,7,1
F632,29,7,4,3,0,22,5,14,3
F635,29,12,9,3,0,17,5,11,1
F634,28,9,7,1,1,19,4,13,2
F637,29,11,9,2,0,18,7,10,1
F636,28,22,12,8,2,6,2,4,0
R622,31,16,10,4,2,15,4,9,2
R623,33,21,12,5,4,12,4,6,2
R620,29,11,5,6,0,18,8,9,1
R621,29,5,4,1,0,24,7,14,3
R626,31,17,10,4,3,14,3,9,2
M799,31,13,11,1,1,18,4,13,1
R624,33,18,11,5,2,15,5,8,2
R625,33,27,17,7,3,6,2,2,2
R628,33,21,16,2,3,12,2,8,2
M798,30,11,9,1,1,19,3,15,1
I559,33,27,17,6,4,6,1,4,1
J749,32,25,14,8,3,7,0,6,1
M791,30,13,6,6,1,17,5,9,3
J741,28,6,5,1,0,22,9,12,1
J740,26,10,5,4,1,16,5,10,1
J743,29,14,8,4,2,15,4,10,1
J742,28,17,11,5,1,11,3,7,1
J745,28,13,6,6,1,15,6,9,0
J744,29,18,8,7,3,11,3,6,2
J747,31,19,6,9,4,12,3,6,3
J746,28,9,6,2,1,19,8,10,1
I558,26,9,4,4,1,17,6,10,1
D648,27,10,6,4,0,17,5,11,1
D642,27,20,8,10,2,7,2,4,1
D643,26,15,9,6,0,11,2,8,1
D640,33,25,13,5,7,8,1,5,2
D641,28,13,9,1,3,15,3,10,2
D647,27,12,6,5,1,15,6,8,1
D644,26,4,1,2,1,22,11,10,1
D645,24,2,2,0,0,22,8,14,0
K768,29,23,11,9,3,6,2,4,0
K769,32,17,9,4,4,15,6,7,2
K761,24,13,8,5,0,11,3,7,1
K762,25,5,3,2,0,20,8,12,0
K764,29,18,13,5,0,11,4,6,1
K765,26,14,8,6,0,12,4,8,0
K766,28,15,10,5,0,13,4,9,0
K767,28,12,8,3,1,16,6,9,1
L642,28,7,3,4,0,21,8,11,2
L643,30,13,9,2,2,17,3,12,2
L640,32,21,14,4,3,11,2,6,3
L641,30,10,6,3,1,20,12,7,1
L646,29,16,11,4,1,13,1,12,0
L647,30,23,11,9,3,7,1,5,1
L644,29,10,7,3,0,19,5,12,2
L645,28,11,8,3,0,17,4,11,2
L648,28,9,5,4,0,19,7,12,0
L649,29,7,4,1,2,22,6,16,0
H822,30,22,11,6,5,8,2,6,0
H820,26,9,4,4,1,17,7,10,0
H821,30,23,14,7,2,7,1,4,2
H826,31,20,12,6,2,11,1,8,2
H827,29,11,10,0,1,18,6,11,1
H824,29,5,4,0,1,24,12,12,0
H825,28,18,12,5,1,10,3,6,1
H828,29,19,9,7,3,10,1,7,2
H829,30,15,9,4,2,15,3,7,5
N839,30,24,14,7,3,6,1,4,1
N838,30,16,8,8,0,14,6,8,0
N833,29,14,9,3,2,15,2,11,2
N832,28,20,9,10,1,8,3,5,0
N831,32,18,9,5,4,14,5,6,3
N830,28,10,9,1,0,18,8,9,1
N837,28,6,1,5,0,22,8,10,4
N836,31,10,7,3,0,21,7,10,4
N835,31,23,12,7,4,8,0,7,1
N834,28,8,4,3,1,20,6,12,2
A749,27,10,5,4,1,17,8,9,0
A744,30,19,11,7,1,11,2,7,2
A745,27,4,2,2,0,23,9,14,0
A746,26,8,6,1,1,18,7,10,1
A747,26,19,11,6,2,7,0,6,1
A740,25,12,8,4,0,13,3,9,1
A741,31,18,8,8,2,13,4,8,1
A742,28,14,7,4,3,14,5,8,1
A743,28,8,4,2,2,20,8,12,0
O658,31,11,6,4,1,20,8,12,0
O659,30,1,1,0,0,29,12,16,1
O650,33,23,11,9,3,10,2,7,1
O651,32,20,15,4,1,12,4,7,1
O652,32,17,8,6,3,15,5,8,2
O653,30,13,6,7,0,17,7,9,1
O654,28,12,7,5,0,16,6,10,0
O655,31,11,11,0,0,20,7,9,4
O657,29,18,8,10,0,11,3,7,1
A568,26,22,11,8,3,4,1,1,2
A569,29,15,12,2,1,14,4,9,1
A560,27,17,9,6,2,10,0,8,2
A561,26,10,5,3,2,16,5,11,0
A562,28,13,7,6,0,15,6,7,2
A564,26,6,4,2,0,20,8,12,0
A565,24,6,5,0,1,18,4,11,3
A566,25,5,4,1,0,20,8,11,1
A567,25,15,10,5,0,10,2,7,1
P596,28,7,6,1,0,21,6,10,5
P597,30,13,10,3,0,17,5,11,1
H778,29,16,10,6,0,13,8,5,0
H779,29,23,11,8,4,6,1,5,0
P592,33,26,14,9,3,7,3,2,2
P593,28,8,7,1,0,20,3,16,1
P590,29,19,8,9,2,10,3,6,1
P591,30,10,6,4,0,20,8,12,0
H772,29,13,11,0,2,16,3,11,2
H773,27,7,6,1,0,20,9,11,0
H771,28,14,12,1,1,14,2,11,1
H776,30,14,9,2,3,16,3,13,0
H777,28,14,9,5,0,14,4,9,1
P598,30,20,9,9,2,10,2,7,1
H775,27,13,7,4,2,14,3,9,2
G643,29,15,7,7,1,14,6,8,0
G642,28,14,8,5,1,14,4,9,1
G641,32,15,6,4,5,17,5,7,5
G640,28,19,11,5,3,9,3,4,2
G647,29,12,6,4,2,17,7,9,1
G646,25,4,3,1,0,21,7,13,1
G645,27,3,2,1,0,24,9,12,3
G644,27,4,3,1,0,23,8,14,1
G648,27,5,3,2,0,22,10,11,1
R594,32,18,10,6,2,14,3,10,1
P772,29,19,11,5,3,10,2,6,2
P773,27,3,2,1,0,24,9,13,2
P770,29,14,9,3,2,15,2,11,2
P771,33,10,7,1,2,23,9,12,2
P776,30,15,10,5,0,15,3,10,2
P777,30,9,7,2,0,21,5,16,0
P774,28,10,5,4,1,18,7,8,3
P775,30,16,10,6,0,14,5,8,1
P778,32,21,13,5,3,11,4,7,0
P779,33,11,5,4,2,22,8,11,3
R598,29,5,3,1,1,24,9,14,1
R599,30,13,8,5,0,17,7,9,1
E639,26,19,10,7,2,7,1,5,1
E634,27,16,9,7,0,11,5,5,1
E635,29,20,13,6,1,9,0,9,0
E636,31,22,13,5,4,9,2,6,1
E637,28,9,8,1,0,19,7,11,1
E631,28,7,3,3,1,21,9,12,0
E632,31,16,7,5,4,15,3,11,1
E633,26,7,5,2,0,19,8,11,0
M634,27,5,4,1,0,22,9,12,1
M635,30,13,9,3,1,17,5,11,1
M636,33,30,18,8,4,3,0,3,0
M637,30,19,14,3,2,11,2,5,4
M630,29,11,8,2,1,18,3,14,1
M631,30,23,13,7,3,7,0,5,2
M632,34,14,7,4,3,20,5,11,4
M633,30,17,8,7,2,13,2,10,1
M638,29,9,7,2,0,20,5,13,2
M639,34,28,16,8,4,6,0,5,1
E543,25,7,4,3,0,18,3,14,1
G587,28,7,6,1,0,21,8,12,1
F796,28,9,6,2,1,19,8,10,1
F797,25,7,6,1,0,18,4,14,0
F794,30,10,7,1,2,20,8,11,1
F795,26,11,6,5,0,15,5,10,0
F792,26,17,11,6,0,9,0,8,1
F793,33,25,16,6,3,8,1,5,2
F790,32,22,13,6,3,10,4,5,1
F791,27,8,5,3,0,19,5,13,1
F798,31,21,10,6,5,10,4,5,1
F799,29,12,8,3,1,17,4,12,1
F572,26,8,4,4,0,18,9,8,1
F573,28,10,7,2,1,18,8,8,2
F570,30,20,12,8,0,10,2,8,0
F571,28,13,8,5,0,15,3,11,1
F576,27,15,9,5,1,12,2,9,1
F577,33,29,14,10,5,4,2,2,0
F574,31,21,12,6,3,10,0,7,3
F575,28,12,10,2,0,16,5,10,1
F578,30,9,6,0,3,21,6,12,3
F579,28,19,11,5,3,9,0,9,0
B685,29,19,10,9,0,10,5,5,0
B686,27,14,7,7,0,13,5,8,0
B687,26,17,12,5,0,9,0,9,0
B680,29,19,12,7,0,10,5,4,1
B681,27,13,9,4,0,14,5,7,2
B682,25,6,6,0,0,19,3,16,0
B683,27,9,8,1,0,18,2,16,0
I528,28,23,11,12,0,5,3,2,0
I529,29,12,9,2,1,17,4,10,3
I524,30,14,6,6,2,16,5,7,4
I525,25,18,10,7,1,7,1,5,1
I526,28,19,9,10,0,9,4,4,1
I527,32,23,13,5,5,9,3,5,1
I520,28,13,9,4,0,15,5,9,1
I521,27,7,5,1,1,20,11,8,1
I522,28,20,11,9,0,8,4,4,0
I523,29,8,5,3,0,21,6,13,2
Q788,30,16,12,3,1,14,3,8,3
Q789,31,24,12,10,2,7,1,4,2
Q780,31,24,14,6,4,7,1,5,1
Q781,30,25,14,8,3,5,1,3,1
Q782,31,5,3,2,0,26,10,13,3
Q783,32,21,14,5,2,11,3,6,2
Q784,28,8,5,3,0,20,6,12,2
Q785,30,21,12,7,2,9,1,7,1
Q786,33,31,19,9,3,2,0,1,1
Q787,30,6,3,3,0,24,9,13,2
Q524,31,2,1,0,1,29,13,15,1
Q526,29,12,10,1,1,17,5,11,1
Q527,31,9,8,0,1,22,9,9,4
Q520,29,14,9,5,0,15,5,10,0
Q521,33,26,13,8,5,7,3,3,1
Q522,33,26,12,10,4,7,1,6,0
Q523,33,16,7,5,4,17,3,12,2
Q528,32,16,7,8,1,16,5,10,1
Q529,30,15,11,4,0,15,4,11,0
R627,33,20,11,5,4,13,1,9,3
R629,33,22,16,4,2,11,1,8,2
P504,32,21,16,4,1,11,0,6,5
L819,27,11,7,4,0,16,2,13,1
L818,34,23,15,4,4,11,3,6,2
L813,31,12,6,5,1,19,6,12,1
L812,29,15,11,2,2,14,0,13,1
L811,29,8,6,2,0,21,7,14,0
L810,30,25,16,6,3,5,0,4,1
L817,33,27,18,8,1,6,1,5,0
L816,29,7,5,2,0,22,7,13,2
L815,30,16,10,6,0,14,4,9,1
L814,27,8,3,5,0,19,6,13,0
R828,32,21,10,9,2,11,5,6,0
R829,32,19,11,6,2,13,4,7,2
R824,32,18,13,4,1,14,3,7,4
R825,34,26,15,8,3,8,2,3,3
R826,32,25,15,10,0,7,2,5,0
R827,33,16,9,4,3,17,6,7,4
R820,32,10,3,4,3,22,9,11,2
R821,31,13,9,2,2,18,7,10,1
R822,30,20,13,7,0,10,4,5,1
R823,28,10,5,3,2,18,4,12,2
H549,28,17,12,3,2,11,3,7,1
H548,30,3,2,0,1,27,10,14,3
H545,26,12,7,5,0,14,4,9,1
H544,28,15,9,5,1,13,4,7,2
H547,28,19,9,8,2,9,3,5,1
H546,29,13,11,2,0,16,4,11,1
H541,28,10,6,3,1,18,7,10,1
H540,26,4,4,0,0,22,8,13,1
H543,24,10,5,5,0,14,1,10,3
E847,27,10,8,1,1,17,4,12,1
E846,28,11,9,1,1,17,6,10,1
E845,28,14,9,3,2,14,3,10,1
E844,30,14,11,2,1,16,3,11,2
E843,28,14,9,4,1,14,6,7,1
E842,25,15,8,5,2,10,3,6,1
E841,28,6,5,1,0,22,9,13,0
E840,29,9,4,5,0,20,9,9,2
E849,31,18,11,4,3,13,3,9,1
E848,26,18,10,6,2,8,1,7,0
R648,33,20,13,7,0,13,4,9,0
R649,31,6,2,2,2,25,9,14,2
R640,32,21,16,4,1,11,2,7,2
R641,30,21,11,8,2,9,2,6,1
R642,33,18,13,5,0,15,3,12,0
R643,31,3,1,1,1,28,10,17,1
R644,29,20,10,9,1,9,3,6,0
R645,32,12,5,4,3,20,7,11,2
R646,29,11,7,4,0,18,6,12,0
R647,30,17,9,7,1,13,3,9,1
D620,25,14,9,4,1,11,2,8,1
D621,25,5,4,1,0,20,7,13,0
D622,28,7,4,2,1,21,7,13,1
D623,32,14,8,4,2,18,9,7,2
D624,31,16,11,2,3,15,7,8,0
D625,32,22,15,5,2,10,3,6,1
D626,27,15,10,5,0,12,3,9,0
D627,29,15,6,8,1,14,6,4,4
D628,27,18,11,7,0,9,4,4,1
D629,29,14,11,1,2,15,3,9,3
K746,30,17,11,4,2,13,5,6,2
K747,30,14,5,6,3,16,3,10,3
K744,28,8,5,2,1,20,7,12,1
K745,27,13,9,4,0,14,2,12,0
K742,26,10,7,3,0,16,6,7,3
K743,30,13,11,1,1,17,5,10,2
K740,27,14,6,5,3,13,4,8,1
K741,28,14,10,4,0,14,6,7,1
K748,28,8,5,2,1,20,5,14,1
K749,31,22,11,7,4,9,2,6,1
M790,32,28,15,9,4,4,0,2,2
L628,31,17,14,2,1,14,2,9,3
L629,30,14,11,3,0,16,5,9,2
L620,31,4,2,1,1,27,12,14,1
L621,29,12,7,4,1,17,4,13,0
L622,31,13,8,4,1,18,5,10,3
L623,34,23,14,3,6,11,3,6,2
L624,30,14,10,3,1,16,4,10,2
L625,30,20,15,3,2,10,0,9,1
L626,30,12,9,2,1,18,6,11,1
L627,30,2,1,1,0,28,10,15,3
H848,28,18,9,9,0,10,3,4,3
H849,29,22,16,6,0,7,1,5,1
H840,27,10,8,2,0,17,7,10,0
H841,27,7,6,0,1,20,8,12,0
H842,29,25,12,9,4,4,0,3,1
H843,29,14,9,2,3,15,5,9,1
H844,28,9,8,0,1,19,6,12,1
H845,30,23,12,9,2,7,0,6,1
H846,29,18,12,5,1,11,4,6,1
H847,28,12,7,5,0,16,7,8,1
N811,29,9,8,1,0,20,7,13,0
N810,33,25,16,6,3,8,2,4,2
N813,31,14,7,5,2,17,5,12,0
N812,29,9,7,2,0,20,6,14,0
N815,29,4,1,3,0,25,10,14,1
N814,28,12,8,4,0,16,3,13,0
N817,31,21,15,6,0,10,4,6,0
N816,32,7,5,1,1,25,9,14,2
N819,27,13,6,7,0,14,2,10,2
N818,33,21,15,2,4,12,2,8,2
O676,32,22,16,4,2,10,2,6,2
O677,28,10,5,5,0,18,7,10,1
O674,31,21,12,6,3,10,4,4,2
O675,34,23,12,5,6,11,3,6,2
O672,30,17,10,7,0,13,4,7,2
O673,34,21,14,3,4,13,3,7,3
O670,31,14,9,3,2,17,6,8,3
O671,32,24,15,8,1,8,2,4,2
A762,26,7,3,2,2,19,7,11,1
A761,25,13,8,5,0,12,3,8,1
A766,27,5,4,1,0,22,9,10,3
A767,26,6,5,0,1,20,7,13,0
O678,32,20,15,4,1,12,2,9,1
O679,31,12,8,4,0,19,6,11,2
I757,27,15,9,5,1,12,2,6,4
I756,27,5,3,0,2,22,10,11,1
I755,30,16,9,5,2,14,3,9,2
I754,28,12,10,1,1,16,4,10,2
I753,29,3,3,0,0,26,7,15,4
I752,24,8,5,3,0,16,3,12,1
I751,24,9,6,3,0,15,3,11,1
I750,27,12,8,4,0,15,4,11,0
Q852,29,18,13,5,0,11,3,8,0
I759,27,4,3,1,0,23,6,16,1
I758,31,15,11,3,1,16,6,8,2
H711,26,5,1,3,1,21,8,12,1
H712,29,14,7,4,3,15,3,9,3
H713,26,13,8,4,1,13,3,8,2
H714,27,10,7,3,0,17,4,12,1
H715,29,12,10,1,1,17,7,8,2
H716,27,6,3,3,0,21,9,12,0
H717,31,22,14,4,4,9,2,6,1
H718,26,15,10,4,1,11,3,7,1
H719,30,14,8,5,1,16,4,10,2
P578,29,17,10,7,0,12,4,6,2
P579,27,7,3,4,0,20,9,11,0
P574,32,16,10,6,0,16,4,11,1
P575,31,13,10,2,1,18,5,10,3
P576,31,21,12,8,1,10,2,7,1
P577,34,30,17,6,7,4,0,4,0
P570,31,14,6,7,1,17,6,9,2
P571,28,7,4,3,0,21,4,16,1
P572,30,13,11,2,0,17,4,10,3
P573,31,7,6,1,0,24,11,9,4
G669,31,13,10,2,1,18,4,11,3
G668,31,24,14,5,5,7,2,4,1
G661,28,13,8,4,1,15,4,8,3
G660,32,26,16,5,5,6,0,5,1
G663,29,13,8,3,2,16,6,9,1
G662,30,26,15,7,4,4,0,2,2
G665,29,11,5,5,1,18,5,12,1
G664,28,20,12,8,0,8,0,8,0
G667,28,5,4,0,1,23,6,14,3
G666,30,21,15,6,0,9,2,4,3
Q855,29,14,8,6,0,15,4,10,1
P718,33,24,9,10,5,9,1,7,1
P719,33,18,11,6,1,15,8,5,2
P710,34,15,4,7,4,19,7,11,1
P711,31,20,12,4,4,11,2,8,1
P712,31,11,6,3,2,20,6,10,4
P713,29,17,10,6,1,12,1,11,0
P714,31,18,11,5,2,13,4,8,1
P715,31,18,12,4,2,13,4,8,1
P716,29,16,11,5,0,13,2,10,1
P717,32,26,17,5,4,6,0,4,2
A814,24,14,4,9,1,10,5,4,1
A815,29,20,11,6,3,9,1,7,1
A816,29,13,7,3,3,16,5,11,0
A817,26,10,9,1,0,16,6,10,0
A810,30,23,13,9,1,7,1,4,2
A543,25,9,6,3,0,16,4,10,2
A540,26,15,7,7,1,11,4,6,1
A813,27,5,3,2,0,22,8,13,1
A818,30,11,7,3,1,19,7,10,2
A819,25,10,5,3,2,15,6,9,0
A548,27,2,2,0,0,25,9,14,2
A549,29,25,14,8,3,4,1,3,0
E619,28,1,1,0,0,27,9,16,2
E612,26,11,5,6,0,15,7,8,0
E613,29,17,15,1,1,12,4,8,0
E610,29,17,7,8,2,12,5,6,1
E611,29,10,6,3,1,19,7,11,1
E616,28,10,4,5,1,18,8,8,2
E617,30,8,4,1,3,22,9,10,3
E614,25,8,5,2,1,17,3,13,1
E615,30,24,12,9,3,6,0,6,0
B848,23,8,5,3,0,15,5,10,0
B849,27,18,12,5,1,9,2,7,0
B846,27,14,10,4,0,13,5,7,1
B847,27,11,7,4,0,16,4,10,2
B844,27,13,11,2,0,14,4,10,0
B845,27,7,6,1,0,20,5,15,0
B842,28,15,12,3,0,13,3,10,0
B843,28,19,11,7,1,9,3,5,1
B840,27,17,12,5,0,10,3,7,0
B841,29,12,8,3,1,17,5,10,2
M612,30,8,7,0,1,22,6,15,1
M613,30,11,9,2,0,19,9,9,1
M610,30,18,11,5,2,12,2,9,1
M611,34,18,10,4,4,16,3,13,0
M616,29,15,8,7,0,14,6,8,0
M617,31,22,16,4,2,9,2,5,2
M614,27,13,9,3,1,14,1,11,2
M615,30,12,8,4,0,18,5,10,3
M618,10,1,0,1,0,9,0,7,2
M619,32,6,5,1,0,26,5,16,5
F778,29,14,11,2,1,15,5,10,0
F779,31,25,12,10,3,6,1,3,2
F774,28,23,11,9,3,5,0,5,0
F775,29,18,12,5,1,11,2,8,1
F776,29,18,9,7,2,11,2,8,1
F777,27,9,5,4,0,18,7,11,0
F771,31,18,11,5,2,13,2,8,3
F772,29,21,11,7,3,8,2,5,1
F773,27,11,8,2,1,16,5,10,1
B518,30,15,12,3,0,15,4,8,3
B519,29,15,11,4,0,14,3,10,1
B514,13,2,1,1,0,11,3,8,0
B515,27,15,12,3,0,12,4,8,0
B516,25,13,9,4,0,12,4,8,0
B517,24,8,6,2,0,16,6,10,0
B510,26,12,9,3,0,14,2,11,1
B511,28,19,14,3,2,9,1,8,0
B512,28,8,7,0,1,20,9,9,2
B513,27,16,11,5,0,11,2,9,0
F518,30,17,12,2,3,13,5,7,1
F519,30,20,9,6,5,10,1,8,1
F510,29,9,5,3,1,20,8,9,3
F511,29,22,13,7,2,7,2,5,0
F512,29,13,10,2,1,16,7,8,1
F513,27,16,8,7,1,11,3,8,0
F514,27,2,2,0,0,25,8,17,0
F515,30,20,16,3,1,10,2,7,1
F516,29,16,8,6,2,13,4,8,1
F517,25,7,5,2,0,18,7,11,0
I508,29,11,6,4,1,18,6,11,1
I509,31,18,7,7,4,13,4,8,1
I502,28,22,13,8,1,6,0,5,1
I503,28,13,9,4,0,15,4,11,0
I506,30,16,7,5,4,14,4,9,1
I507,28,5,3,2,0,23,10,12,1
I504,29,17,11,4,2,12,4,6,2
I505,29,13,8,3,2,16,3,12,1
Q502,27,11,8,2,1,16,7,7,2
Q503,32,21,12,8,1,11,2,7,2
Q506,29,10,6,4,0,19,4,14,1
Q507,33,19,10,6,3,14,3,10,1
Q504,32,21,12,4,5,11,3,6,2
Q505,26,5,4,1,0,21,5,15,1
Q508,28,7,4,2,1,21,5,14,2
Q509,31,20,13,7,0,11,1,10,0
L831,31,20,12,5,3,11,2,6,3
L830,29,19,16,3,0,10,1,6,3
L833,29,9,4,4,1,20,5,13,2
L832,29,10,4,4,2,19,5,11,3
N558,28,12,8,3,1,16,6,9,1
N559,31,27,14,9,4,4,2,1,1
L837,26,2,0,2,0,24,3,19,2
L836,31,15,10,3,2,16,2,10,4
N554,34,26,12,10,4,8,4,4,0
N555,30,10,4,6,0,20,7,13,0
N556,30,8,7,0,1,22,9,10,3
N557,30,9,6,2,1,21,8,11,2
N550,30,18,8,8,2,12,5,5,2
N551,31,23,13,7,3,8,3,4,1
N552,32,22,11,8,3,10,2,8,0
N553,27,8,5,2,1,19,5,13,1
R808,28,4,3,1,0,24,9,13,2
R809,29,18,13,5,0,11,5,6,0
R802,31,16,8,6,2,15,5,7,3
R803,28,12,8,3,1,16,2,12,2
R800,33,12,8,2,2,21,7,12,2
R801,32,18,13,3,2,14,4,9,1
R806,31,14,6,6,2,17,7,9,1
R807,33,18,10,5,3,15,1,12,2
R804,31,17,10,7,0,14,3,11,0
R805,32,15,10,4,1,17,4,10,3
H529,27,11,6,4,1,16,4,10,2
H528,30,20,9,8,3,10,3,7,0
H523,30,8,4,3,1,22,7,14,1
H522,28,16,7,7,2,12,3,8,1
H521,28,14,10,2,2,14,6,7,1
H520,30,13,9,2,2,17,5,11,1
H527,29,18,9,9,0,11,5,3,3
H526,28,12,8,4,0,16,7,8,1
H525,26,17,10,7,0,9,2,7,0
H524,27,14,9,4,1,13,2,11,0
E590,29,1,0,0,1,28,10,15,3
E593,31,9,5,3,1,22,7,10,5
C547,26,11,9,2,0,15,5,9,1
E595,29,12,8,3,1,17,7,9,1
E594,29,15,10,5,0,14,7,4,3
C543,30,10,6,4,0,20,5,15,0
R666,34,30,17,9,4,4,1,1,2
R667,32,21,13,8,0,11,1,7,3
R664,28,11,6,4,1,17,5,11,1
R665,28,2,2,0,0,26,6,15,5
R662,34,22,16,3,3,12,3,7,2
R663,32,21,9,8,4,11,4,4,3
R660,31,23,16,5,2,8,0,6,2
E598,29,11,8,1,2,18,6,11,1
R668,33,27,14,10,3,6,1,3,2
R669,30,8,4,4,0,22,8,13,1
D608,27,6,4,2,0,21,6,11,4
D606,30,15,10,2,3,15,5,8,2
D607,30,24,11,10,3,6,0,5,1
D604,29,15,10,5,0,14,6,8,0
D605,29,16,10,6,0,13,4,7,2
D602,28,18,9,5,4,10,2,8,0
D603,29,14,8,5,1,15,6,6,3
D600,26,9,7,2,0,17,5,9,3
L606,31,20,17,1,2,11,1,8,2
L607,33,23,13,6,4,10,2,4,4
L604,30,17,12,3,2,13,4,8,1
L605,31,11,7,3,1,20,8,11,1
L602,33,18,7,8,3,15,7,7,1
L603,32,26,14,9,3,6,3,3,0
L600,29,13,5,5,3,16,5,10,1
L601,29,8,6,2,0,21,5,14,2
L608,24,10,7,3,0,14,2,11,1
B727,27,22,10,9,3,5,0,5,0
B726,26,6,6,0,0,20,7,12,1
B725,27,17,10,6,1,10,3,7,0
B724,25,19,13,6,0,6,0,6,0
B723,32,22,11,5,6,10,1,7,2
B722,30,16,14,1,1,14,2,12,0
B721,29,19,14,3,2,10,3,6,1
B720,27,10,9,1,0,17,6,11,0
B729,27,10,8,2,0,17,7,9,1
B728,26,12,6,5,1,14,6,8,0
O698,33,15,12,1,2,18,6,10,2
O699,31,19,14,4,1,12,2,9,1
O694,25,3,3,0,0,22,4,16,2
O695,34,19,10,4,5,15,7,7,1
O690,30,10,7,3,0,20,7,13,0
O692,30,13,10,3,0,17,4,12,1
O693,30,8,4,3,1,22,6,15,1
I779,28,27,9,13,5,1,0,0,1
I778,27,6,5,1,0,21,11,10,0
I775,28,7,7,0,0,21,6,12,3
I774,26,8,5,3,0,18,6,11,1
I777,28,13,10,3,0,15,1,13,1
I776,28,15,8,6,1,13,4,7,2
I771,27,7,6,1,0,20,9,11,0
P594,28,9,6,2,1,19,7,11,1
I773,27,11,7,4,0,16,4,11,1
I772,27,12,7,2,3,15,4,10,1
J695,32,19,11,5,3,13,6,6,1
P595,31,21,12,8,1,10,3,5,2
J693,30,6,5,1,0,24,7,14,3
J692,26,8,5,3,0,18,6,11,1
J690,28,11,7,3,1,17,4,13,0
J699,29,23,12,11,0,6,4,2,0
J698,28,14,10,4,0,14,6,7,1
H738,28,18,14,3,1,10,1,6,3
H739,28,16,7,7,2,12,4,8,0
H736,26,15,6,7,2,11,4,7,0
H737,29,16,12,3,1,13,4,8,1
H734,29,17,10,7,0,12,2,9,1
H732,27,10,5,5,0,17,7,9,1
H733,25,4,4,0,0,21,7,13,1
H730,28,15,6,6,3,13,6,6,1
H731,30,26,16,7,3,4,0,4,0
P558,27,14,9,5,0,13,4,9,0
P559,35,26,13,5,8,9,4,5,0
P552,32,24,14,9,1,8,2,5,1
P553,29,24,11,10,3,5,2,1,2
P550,30,8,4,3,1,22,8,12,2
P551,32,21,15,3,3,11,2,7,2
P556,33,20,14,3,3,13,2,9,2
P557,30,18,9,6,3,12,4,5,3
P554,34,24,12,9,3,10,1,7,2
P555,30,7,3,4,0,23,9,14,0
A700,27,6,4,2,0,21,8,11,2
A701,30,26,18,8,0,4,1,3,0
A702,25,10,7,3,0,15,6,9,0
A703,29,21,11,7,3,8,2,5,1
A704,28,13,5,4,4,15,5,8,2
H774,26,9,6,2,1,17,5,11,1
A708,30,20,11,7,2,10,4,5,1
P599,31,17,9,7,1,14,7,5,2
P736,30,24,11,10,3,6,0,5,1
P737,32,15,14,0,1,17,5,10,2
P734,29,7,5,1,1,22,3,16,3
P735,31,13,6,6,1,18,5,12,1
P732,31,20,13,7,0,11,2,6,3
P733,29,13,9,2,2,16,5,11,0
P730,32,11,6,2,3,21,7,13,1
P731,32,27,17,7,3,5,2,2,1
P738,32,25,16,7,2,7,0,5,2
P739,32,22,12,9,1,10,5,4,1
A832,25,15,9,5,1,10,0,9,1
A833,26,15,6,6,3,11,2,7,2
A830,27,12,9,3,0,15,5,8,2
A831,27,22,12,7,3,5,1,3,1
A836,27,15,9,6,0,12,5,7,0
C798,26,14,9,5,0,12,3,9,0
A834,27,15,8,4,3,12,2,8,2
A835,26,13,9,3,1,13,3,8,2
C795,27,16,9,7,0,11,4,7,0
C794,27,7,7,0,0,20,8,11,1
A838,27,10,4,5,1,17,6,9,2
A839,28,23,17,5,1,5,0,5,0
C791,27,11,3,7,1,16,7,9,0
C790,28,20,14,5,1,8,2,5,1
C793,31,14,9,3,2,17,5,10,2
C792,27,7,2,5,0,20,8,12,0
E670,28,15,12,3,0,13,5,7,1
E671,33,26,14,6,6,7,0,6,1
E672,26,13,8,5,0,13,4,8,1
E673,28,12,11,1,0,16,4,11,1
E674,29,16,12,2,2,13,3,9,1
E675,30,14,10,2,2,16,4,9,3
E676,30,18,11,5,2,12,6,4,2
E677,27,14,8,5,1,13,3,9,1
E678,32,22,13,6,3,10,3,6,1
E679,28,12,7,5,0,16,5,9,2
N767,29,8,8,0,0,21,8,12,1
N766,33,26,17,9,0,7,0,4,3
N765,27,20,9,6,5,7,0,7,0
N764,31,16,9,4,3,15,6,7,2
N763,21,13,4,7,2,8,0,6,2
N762,29,2,1,0,1,27,11,15,1
N761,26,9,5,4,0,17,4,12,1
N760,30,9,7,1,1,21,4,16,1
N769,30,21,16,5,0,9,2,6,1
N768,32,19,10,6,3,13,5,7,1
M678,32,16,13,2,1,16,2,11,3
M679,31,7,2,3,2,24,11,12,1
M670,32,10,6,2,2,22,9,10,3
M671,33,25,17,4,4,8,0,6,2
M672,31,16,10,5,1,15,6,8,1
M673,33,20,12,4,4,13,4,8,1
M674,31,21,14,2,5,10,2,7,1
M675,32,22,12,7,3,10,3,4,3
M676,32,16,13,2,1,16,4,9,3
M677,30,9,7,2,0,21,7,13,1
F758,31,19,10,6,3,12,4,5,3
F759,7,0,0,0,0,7,1,6,0
F752,29,15,8,5,2,14,3,9,2
F753,28,15,6,8,1,13,6,7,0
F750,28,7,5,2,0,21,7,13,1
F751,27,14,9,4,1,13,3,9,1
F756,25,11,6,5,0,14,5,9,0
F757,27,12,8,4,0,15,5,9,1
F754,27,13,11,2,0,14,5,8,1
F755,28,10,5,4,1,18,6,10,2
B538,27,11,8,1,2,16,4,10,2
B539,29,21,13,4,4,8,1,6,1
B533,28,17,11,6,0,11,2,9,0
B530,28,16,11,4,1,12,2,8,2
B531,26,4,3,1,0,22,5,17,0
B536,26,1,1,0,0,25,13,12,0
B537,25,6,4,1,1,19,6,11,2
B534,28,17,12,5,0,11,3,7,1
B535,30,21,13,7,1,9,1,7,1
F536,32,24,15,5,4,8,0,6,2
J506,30,15,9,4,2,15,4,8,3
J505,29,16,7,6,3,13,3,8,2
J504,30,23,14,7,2,7,1,4,2
J503,28,18,13,5,0,10,1,8,1
J502,29,17,11,4,2,12,1,9,2
F530,29,18,12,3,3,11,1,8,2
F531,27,15,10,5,0,12,2,10,0
J509,28,16,9,6,1,12,3,9,0
F539,30,20,15,5,0,10,3,7,0
I560,32,18,8,6,4,14,1,10,3
I561,26,10,4,5,1,16,7,9,0
I562,28,20,14,6,0,8,1,6,1
I564,27,10,7,3,0,17,6,10,1
I565,29,13,6,4,3,16,6,9,1
I566,26,11,8,3,0,15,4,11,0
I567,26,2,1,1,0,24,10,11,3
I568,26,14,10,3,1,12,0,10,2
I569,32,24,15,6,3,8,3,5,0
N583,27,10,7,3,0,17,6,10,1
Q748,32,25,12,8,5,7,0,7,0
Q749,30,8,6,2,0,22,7,11,4
N582,29,11,8,3,0,18,5,13,0
Q744,32,13,8,5,0,19,5,11,3
Q745,34,24,11,13,0,10,3,7,0
Q746,32,14,11,2,1,18,7,8,3
Q747,29,3,2,1,0,26,9,16,1
Q740,30,4,3,1,0,26,11,13,2
Q741,31,7,4,2,1,24,11,13,0
Q742,29,14,8,6,0,15,6,6,3
Q743,32,16,11,4,1,16,4,11,1
L803,25,10,7,2,1,15,2,12,1
L804,28,11,4,6,1,17,6,10,1
L805,31,15,9,5,1,16,4,9,3
N585,29,9,6,2,1,20,6,14,0
N584,23,4,1,2,1,19,2,14,3
Q568,31,24,12,8,4,7,2,5,0
Q569,32,20,14,3,3,12,4,7,1
Q560,27,11,4,6,1,16,5,9,2
Q561,27,11,9,2,0,16,3,13,0
Q562,33,28,14,10,4,5,2,3,0
Q563,29,15,9,6,0,14,3,11,0
Q564,28,19,11,7,1,9,1,6,2
Q565,26,5,2,3,0,21,8,13,0
Q566,26,8,4,4,0,18,9,9,0
Q567,29,4,4,0,0,25,9,14,2
K528,28,12,6,5,1,16,5,9,2
K529,28,7,3,4,0,21,8,10,3
K526,28,13,9,3,1,15,5,9,1
K527,32,25,13,8,4,7,2,3,2
K524,29,16,8,7,1,13,6,7,0
O514,32,17,8,5,4,15,1,14,0
K522,30,20,10,7,3,10,2,8,0
K523,30,15,8,5,2,15,3,11,1
K520,26,8,4,4,0,18,8,10,0
O510,31,20,11,7,2,11,2,8,1
O588,32,11,7,4,0,21,7,12,2
O589,32,22,12,8,2,10,2,8,0
N578,33,21,10,8,3,12,5,6,1
N579,28,10,7,3,0,18,5,13,0
N572,31,15,12,2,1,16,3,12,1
N573,33,9,6,1,2,24,10,11,3
N570,32,13,8,3,2,19,7,11,1
N571,30,7,4,3,0,23,5,14,4
N576,29,15,8,7,0,14,5,8,1
N577,34,28,16,6,6,6,1,5,0
N574,29,6,3,3,0,23,8,15,0
N575,31,16,11,4,1,15,7,6,2
H503,27,13,9,4,0,14,5,9,0
H502,28,12,9,3,0,16,4,10,2
H505,26,7,5,2,0,19,7,12,0
H504,28,17,13,1,3,11,2,8,1
H507,28,7,5,2,0,21,9,11,1
H506,28,13,8,5,0,15,4,9,2
H509,30,16,11,3,2,14,1,13,0
H508,33,14,7,5,2,19,3,12,4
E809,31,13,8,3,2,18,5,10,3
E803,25,10,7,3,0,15,4,11,0
E802,33,29,14,10,5,4,1,3,0
E801,30,20,14,4,2,10,2,7,1
E800,27,16,10,5,1,11,2,7,2
E807,26,12,7,4,1,14,5,8,1
E805,28,14,12,1,1,14,2,10,2
E804,25,12,4,7,1,13,5,6,2
N680,28,16,11,5,0,12,3,9,0
N681,30,13,6,7,0,17,5,10,2
N682,32,17,10,5,2,15,1,12,2
N683,33,22,8,10,4,11,2,7,2
N685,32,7,7,0,0,25,3,19,3
N686,32,19,12,7,0,13,2,11,0
N687,29,17,10,6,1,12,2,6,4
N688,31,13,9,3,1,18,4,13,1
N689,30,24,10,10,4,6,1,4,1
R688,29,11,6,4,1,18,5,13,0
R689,31,22,10,8,4,9,1,7,1
R685,28,5,4,1,0,23,5,16,2
R686,32,18,10,8,0,14,2,12,0
R687,29,19,8,8,3,10,4,4,2
R680,29,23,13,10,0,6,1,4,1
R681,28,11,8,3,0,17,6,10,1
R682,31,13,8,4,1,18,5,12,1
R683,32,17,5,8,4,15,4,9,2
D592,28,20,14,4,2,8,1,6,1
B740,27,14,8,6,0,13,4,9,0
B743,28,13,9,3,1,15,4,10,1
J819,24,9,5,4,0,15,5,10,0
K838,26,12,6,6,0,14,6,8,0
K839,33,17,12,2,3,16,6,8,2
K834,26,5,3,1,1,21,7,13,1
K835,29,22,12,7,3,7,2,4,1
K836,30,13,9,3,1,17,4,10,3
K830,29,15,11,2,2,14,3,10,1
K831,30,14,10,3,1,16,7,8,1
K832,24,4,2,2,0,20,9,11,0
K833,27,10,6,3,1,17,4,10,3
B747,25,13,8,4,1,12,2,10,0
B746,27,11,9,2,0,16,6,9,1
J818,29,12,7,2,3,17,7,10,0
B749,30,13,6,6,1,17,6,7,4
D846,29,12,10,1,1,17,4,11,2
D847,26,7,4,2,1,19,6,12,1
K788,30,6,6,0,0,24,9,11,4
K789,31,17,11,4,2,14,4,9,1
K782,32,17,7,7,3,15,5,7,3
K783,28,15,10,4,1,13,3,8,2
K780,29,16,11,5,0,13,4,8,1
K781,28,16,10,5,1,12,5,5,2
K786,34,23,14,3,6,11,5,5,1
K787,24,16,9,5,2,8,1,7,0
K784,32,14,7,6,1,18,5,10,3
K785,28,4,3,1,0,24,7,16,1
B708,30,24,15,6,3,6,1,4,1
B705,24,8,7,1,0,16,4,12,0
B704,28,11,6,5,0,17,7,10,0
B701,30,23,17,4,2,7,0,6,1
B700,27,7,5,2,0,20,7,13,0
B703,28,22,14,7,1,6,1,5,0
B702,27,18,11,4,3,9,2,7,0
R724,31,17,8,8,1,14,4,7,3
I719,30,10,8,1,1,20,4,13,3
I718,28,11,6,3,2,17,5,11,1
I713,27,13,6,6,1,14,4,10,0
I712,28,17,8,8,1,11,3,7,1
I711,26,11,7,4,0,15,3,11,1
I717,29,17,10,6,1,12,6,5,1
I716,25,8,4,4,0,17,4,11,2
I715,29,14,10,3,1,15,3,9,3
I714,29,20,12,5,3,9,3,6,0
P530,31,11,7,2,2,20,8,10,2
P531,27,10,7,3,0,17,5,12,0
P532,29,8,4,3,1,21,8,12,1
P533,33,25,13,10,2,8,1,6,1
P534,31,18,12,5,1,13,3,9,1
P535,31,22,11,7,4,9,2,6,1
P536,33,29,12,10,7,4,1,1,2
P537,30,9,5,3,1,21,7,13,1
P538,29,15,7,8,0,14,4,9,1
P539,31,17,11,5,1,14,6,5,3
A728,27,17,9,6,2,10,2,3,5
A729,27,21,14,5,2,6,0,6,0
A726,26,4,3,1,0,22,10,11,1
A727,26,14,10,4,0,12,2,7,3
A724,25,16,9,7,0,9,4,5,0
A725,26,13,6,5,2,13,6,6,1
A722,26,16,12,4,0,10,3,6,1
A723,30,17,9,7,1,13,3,6,4
A720,27,10,7,2,1,17,7,10,0
A721,29,17,12,5,0,12,5,7,0
A588,27,7,3,4,0,20,10,10,0
A589,29,20,10,7,3,9,2,4,3
A850,23,1,0,1,0,22,7,15,0
A851,26,13,9,4,0,13,4,7,2
A580,25,11,7,3,1,14,4,8,2
A853,28,13,9,3,1,15,5,10,0
A854,25,7,4,2,1,18,6,9,3
A855,25,10,7,3,0,15,4,10,1
G777,27,6,4,2,0,21,9,12,0
G776,29,18,11,6,1,11,3,7,1
G775,29,17,9,7,1,12,3,7,2
G774,25,9,6,3,0,16,3,12,1
G773,26,7,3,4,0,19,7,11,1
G772,26,9,7,2,0,17,5,10,2
G771,31,19,10,6,3,12,5,6,1
G779,29,18,8,7,3,11,1,5,5
G778,31,20,15,3,2,11,2,8,1
E658,27,12,8,4,0,15,4,8,3
E659,28,14,8,6,0,14,4,9,1
E657,30,23,10,9,4,7,1,4,2
E654,28,14,12,1,1,14,3,9,2
E655,31,26,16,6,4,5,1,3,1
E652,26,0,0,0,0,26,11,14,1
E653,28,7,5,0,2,21,7,13,1
E650,29,21,10,10,1,8,1,6,1
E651,29,18,13,4,1,11,2,7,2
N749,30,12,7,5,0,18,6,8,4
N748,31,11,8,1,2,20,3,15,2
N745,34,24,14,9,1,10,2,7,1
N744,31,19,11,6,2,12,4,7,1
N747,27,13,7,5,1,14,4,8,2
N746,32,11,8,3,0,21,10,10,1
N741,32,22,12,9,1,10,2,6,2
N740,29,18,9,9,0,11,5,6,0
N743,32,17,8,7,2,15,6,7,2
N742,32,10,5,2,3,22,10,11,1
M657,29,6,2,4,0,23,10,10,3
M654,29,10,6,4,0,19,6,12,1
M655,30,12,9,3,0,18,6,8,4
M652,31,5,2,2,1,26,11,13,2
M653,33,19,11,6,2,14,2,11,1
M650,30,6,5,0,1,24,9,12,3
M651,32,24,15,8,1,8,2,3,3
M658,31,12,6,5,1,19,8,11,0
M659,32,18,10,6,2,14,2,7,5
F730,29,21,10,8,3,8,2,5,1
F731,31,18,12,3,3,13,3,8,2
F732,26,9,4,5,0,17,8,6,3
F733,26,8,7,1,0,18,3,15,0
F734,27,5,4,1,0,22,7,15,0
F736,25,15,8,6,1,10,1,7,2
F737,29,20,12,8,0,9,3,3,3
F738,29,15,10,3,2,14,6,7,1
F739,26,5,3,1,1,21,8,12,1
J529,28,17,11,6,0,11,3,7,1
J528,28,20,10,10,0,8,2,5,1
J525,29,15,6,6,3,14,4,9,1
J524,29,12,8,2,2,17,5,10,2
J527,28,24,16,7,1,4,1,2,1
J526,33,15,10,3,2,18,7,10,1
J521,27,8,7,1,0,19,9,9,1
J520,27,14,10,4,0,13,3,8,2
J523,30,13,6,5,2,17,5,10,2
J522,30,14,9,5,0,16,5,9,2
I548,31,11,7,3,1,20,3,14,3
I549,30,24,15,6,3,6,1,5,0
I546,29,21,10,10,1,8,3,4,1
I547,27,16,7,7,2,11,4,7,0
I544,28,14,5,6,3,14,7,7,0
I545,26,4,2,1,1,22,6,13,3
I543,26,14,11,3,0,12,0,10,2
I540,27,3,3,0,0,24,9,15,0
I541,29,10,3,6,1,19,9,8,2
Q768,28,16,8,6,2,12,5,6,1
Q769,31,10,9,1,0,21,9,9,3
Q762,29,13,8,4,1,16,4,11,1
Q763,25,10,8,2,0,15,6,9,0
Q760,30,18,10,7,1,12,1,9,2
Q761,26,9,8,1,0,17,4,13,0
Q766,31,14,10,3,1,17,4,10,3
Q767,30,11,7,3,1,19,5,9,5
Q764,32,20,13,4,3,12,3,7,2
Q765,28,16,8,7,1,12,3,6,3
B550,23,9,5,4,0,14,7,7,0
B551,30,21,12,6,3,9,3,4,2
B552,28,9,5,4,0,19,7,12,0
B553,24,9,4,5,0,15,5,10,0
B554,27,25,13,10,2,2,0,1,1
B555,28,12,8,4,0,16,5,10,1
B556,30,21,13,6,2,9,1,6,2
B557,26,17,11,6,0,9,3,5,1
B558,25,5,2,2,1,20,8,11,1
B559,28,14,10,4,0,14,7,6,1
Q814,30,21,12,8,1,9,2,5,2
Q815,31,12,6,4,2,19,5,13,1
Q544,29,13,10,3,0,16,3,12,1
Q545,28,16,9,6,1,12,2,10,0
Q542,26,6,4,2,0,20,6,14,0
Q811,30,15,9,5,1,15,4,9,2
Q812,28,3,0,3,0,25,12,13,0
Q813,30,4,1,3,0,26,11,14,1
Q818,32,6,4,1,1,26,13,12,1
Q819,31,23,11,9,3,8,1,6,1
Q548,28,3,2,1,0,25,8,17,0
Q549,34,24,15,7,2,10,4,5,1
R639,32,19,10,8,1,13,6,6,1
K647,29,17,8,7,2,12,4,7,1
K646,31,21,11,6,4,10,1,8,1
K645,27,4,4,0,0,23,7,14,2
K644,29,17,9,6,2,12,3,7,2
K643,27,14,6,7,1,13,4,6,3
K642,26,9,5,4,0,17,6,10,1
K641,28,18,10,7,1,10,3,6,1
K640,33,21,10,6,5,12,5,4,3
K649,28,8,6,1,1,20,4,13,3
K648,27,11,7,4,0,16,4,10,2
R848,28,11,8,2,1,17,4,12,1
R849,34,23,15,5,3,11,3,6,2
R846,34,26,15,7,4,8,2,5,1
R847,29,12,7,5,0,17,5,11,1
R844,32,17,11,4,2,15,3,11,1
R845,30,6,5,1,0,24,7,15,2
R842,30,24,12,10,2,6,1,5,0
R843,32,13,8,3,2,19,6,9,4
R840,33,18,11,5,2,15,7,6,2
R841,32,13,10,1,2,19,7,9,3
N510,30,12,6,5,1,18,7,9,2
N511,32,19,14,2,3,13,3,9,1
N512,33,24,12,6,6,9,3,4,2
N513,31,23,11,11,1,8,4,3,1
N514,31,13,6,6,1,18,3,14,1
N515,30,14,12,1,1,16,6,9,1
N516,28,11,7,4,0,17,5,12,0
N517,30,11,7,4,0,19,7,12,0
N518,32,21,15,5,1,11,3,5,3
N519,30,17,7,9,1,13,6,6,1
R518,32,9,7,2,0,23,10,9,4
R519,29,6,3,2,1,23,8,12,3
R514,30,16,9,6,1,14,0,12,2
R515,32,19,17,1,1,13,1,9,3
R516,30,18,12,5,1,12,2,9,1
R517,30,15,8,6,1,15,4,10,1
R510,29,13,8,4,1,16,4,11,1
R511,32,25,14,7,4,7,2,4,1
R512,33,21,15,4,2,12,4,6,2
R513,31,16,12,3,1,15,3,10,2
Q586,30,16,9,6,1,14,3,10,1
A807,27,15,10,4,1,12,2,9,1
E821,28,20,15,4,1,8,0,7,1
E820,26,13,8,5,0,13,3,10,0
E822,29,24,12,9,3,5,1,3,1
E825,28,14,12,2,0,14,4,10,0
E824,28,13,11,2,0,15,6,9,0
E827,29,19,14,4,1,10,3,6,1
E826,29,17,8,5,4,12,1,8,3
E829,31,19,13,3,3,12,2,9,1
E828,28,16,9,7,0,12,2,9,1
A805,28,14,11,3,0,14,3,9,2
K818,29,16,11,4,1,13,5,6,2
K819,26,10,5,3,2,16,3,11,2
K812,25,7,5,2,0,18,5,12,1
K813,29,10,8,1,1,19,4,13,2
K810,33,27,14,8,5,6,3,2,1
K811,29,13,8,4,1,16,3,12,1
K816,32,25,12,8,5,7,1,6,0
K817,30,17,12,4,1,13,4,8,1
K814,26,8,4,4,0,18,5,13,0
K815,29,10,6,1,3,19,4,13,2
A804,23,9,4,4,1,14,4,7,3
A803,27,8,7,0,1,19,4,12,3
A801,27,18,11,6,1,9,2,5,2
B769,30,23,11,10,2,7,3,2,2
B768,27,21,15,6,0,6,1,5,0
B762,27,10,7,3,0,17,4,10,3
B761,26,8,4,4,0,18,7,11,0
B767,27,15,8,6,1,12,4,7,1
B766,27,9,6,3,0,18,7,11,0
B765,25,10,7,3,0,15,4,11,0
B764,27,9,7,2,0,18,10,8,0
I731,32,28,18,7,3,4,1,2,1
I730,31,15,8,5,2,16,4,8,4
I733,25,9,5,4,0,16,4,12,0
I732,28,11,6,5,0,17,6,10,1
I734,27,7,4,3,0,20,6,12,2
I737,28,20,11,8,1,8,4,3,1
I736,26,19,9,10,0,7,2,3,2
I739,27,7,5,1,1,20,6,11,3
I738,30,17,9,4,4,13,5,7,1
O583,28,7,2,4,1,21,9,8,4
P518,30,10,8,2,0,20,11,7,2
P519,31,18,8,8,2,13,3,8,2
P516,30,15,11,4,0,15,0,10,5
P517,29,10,3,7,0,19,8,10,1
P514,31,7,5,2,0,24,4,19,1
P515,31,18,15,2,1,13,3,7,3
P512,31,12,8,2,2,19,7,10,2
P513,33,17,8,3,6,16,5,10,1
P510,29,14,7,6,1,15,3,8,4
P511,34,27,17,7,3,7,0,4,3
G759,26,2,2,0,0,24,8,16,0
G758,27,12,8,4,0,15,4,8,3
G755,27,12,6,5,1,15,6,9,0
G754,31,20,11,6,3,11,3,8,0
G757,29,19,10,5,4,10,2,8,0
G756,29,9,5,2,2,20,7,11,2
G751,28,14,6,5,3,14,4,9,1
G750,28,8,5,3,0,20,8,11,1
G753,27,14,8,5,1,13,7,6,0
G752,29,15,9,5,1,14,3,10,1
N729,33,22,15,5,2,11,3,6,2
N728,28,10,3,6,1,18,10,7,1
N723,31,21,13,7,1,10,3,6,1
N722,33,22,14,4,4,11,2,6,3
N721,32,27,16,7,4,5,1,3,1
N720,32,22,15,4,3,10,3,6,1
N727,30,18,9,7,2,12,4,7,1
N726,29,12,8,4,0,17,7,9,1
N725,31,8,6,1,1,23,9,10,4
N724,30,15,8,6,1,15,2,10,3
F718,26,11,8,3,0,15,5,10,0
F719,29,18,10,6,2,11,1,8,2
F716,30,18,8,8,2,12,3,9,0
F717,28,19,12,6,1,9,4,4,1
F714,30,6,5,0,1,24,7,12,5
F715,30,11,8,1,2,19,7,10,2
F712,29,10,7,2,1,19,5,13,1
F713,27,13,8,4,1,14,3,8,3
F711,26,2,1,0,1,24,9,14,1
R727,32,20,11,4,5,12,2,9,1
R726,32,14,9,3,2,18,8,7,3
J549,31,24,15,6,3,7,2,3,2
J548,28,9,6,2,1,19,4,14,1
R723,30,5,2,2,1,25,15,10,0
R722,32,24,15,5,4,8,2,5,1
R721,31,20,12,5,3,11,2,7,2
R720,33,26,16,5,5,7,2,5,0
J543,26,2,1,1,0,24,9,14,1
J541,29,11,6,3,2,18,6,10,2
J540,27,2,1,1,0,25,10,15,0
J547,27,17,10,7,0,10,3,7,0
J546,28,21,12,7,2,7,2,5,0
J545,28,12,6,5,1,16,5,9,2
J544,28,12,7,5,0,16,6,9,1
Q700,28,12,8,4,0,16,6,9,1
Q701,32,26,13,8,5,6,2,3,1
Q702,33,24,12,7,5,9,3,5,1
Q704,33,14,7,5,2,19,7,10,2
Q705,28,8,4,3,1,20,6,12,2
Q706,28,11,7,2,2,17,4,12,1
Q707,32,24,9,10,5,8,3,4,1
Q708,34,29,17,8,4,5,1,3,1
Q709,27,13,9,2,2,14,1,13,0
B578,27,9,8,1,0,18,6,11,1
B579,25,10,6,4,0,15,6,9,0
B576,30,22,13,9,0,8,0,8,0
B577,31,23,15,7,1,8,2,4,2
B574,28,15,10,5,0,13,2,11,0
B575,28,2,1,0,1,26,11,14,1
B573,26,3,2,1,0,23,10,11,2
B570,29,13,7,5,1,16,4,11,1
B571,27,7,5,2,0,20,4,15,1
Q832,30,14,10,1,3,16,2,14,0
Q833,33,15,7,4,4,18,4,12,2
Q830,31,22,13,7,2,9,3,4,2
Q831,33,16,11,3,2,17,7,8,2
Q836,33,13,10,2,1,20,3,13,4
Q834,30,16,8,6,2,14,4,9,1
Q835,33,15,8,3,4,18,7,8,3
Q838,31,25,12,12,1,6,3,3,0
Q839,31,13,9,3,1,18,7,8,3
K669,28,18,11,7,0,10,2,7,1
K668,31,16,10,3,3,15,5,7,3
K665,29,7,3,3,1,22,7,14,1
K664,25,11,6,5,0,14,3,11,0
K667,28,9,4,5,0,19,7,9,3
K666,33,30,19,10,1,3,1,1,1
K661,28,12,7,3,2,16,6,8,2
K660,29,19,13,3,3,10,2,7,1
K663,28,13,10,2,1,15,2,11,2
K662,30,18,14,2,2,12,2,7,3
L787,30,24,11,8,5,6,1,5,0
L786,32,22,16,5,1,10,4,4,2
L785,29,9,4,5,0,20,9,10,1
L784,29,9,6,2,1,20,5,14,1
L783,30,18,12,5,1,12,5,6,1
L782,30,5,2,2,1,25,11,12,2
L781,29,14,9,5,0,15,5,9,1
L780,32,19,12,3,4,13,2,10,1
L789,30,12,9,3,0,18,5,11,2
L788,30,13,10,2,1,17,7,9,1
O791,32,9,5,3,1,23,6,16,1
O790,33,25,15,5,5,8,1,5,2
O793,33,24,15,5,4,9,2,6,1
O792,30,13,7,6,0,17,5,11,1
O795,27,11,7,4,0,16,3,10,3
O794,31,22,14,5,3,9,1,5,3
O797,27,2,2,0,0,25,9,16,0
O796,32,17,13,3,1,15,5,9,1
O799,31,10,6,3,1,21,9,11,1
O798,31,3,3,0,0,28,11,15,2
A681,27,19,11,5,3,8,1,7,0
A680,25,17,11,5,1,8,1,6,1
A683,27,7,5,1,1,20,4,16,0
A682,23,3,3,0,0,20,7,12,1
A685,24,18,7,6,5,6,1,4,1
A687,25,16,7,7,2,9,3,5,1
A686,28,21,12,9,0,7,0,6,1
A579,27,12,6,5,1,15,5,9,1
M698,31,19,15,2,2,12,3,8,1
M699,31,20,12,7,1,11,2,9,0
N538,28,7,3,3,1,21,12,8,1
N539,32,22,16,6,0,10,2,6,2
N536,31,24,13,9,2,7,2,3,2
N537,31,12,8,3,1,19,6,11,2
N534,32,21,9,7,5,11,4,6,1
N535,30,25,14,11,0,5,2,3,0
N532,29,8,4,3,1,21,7,14,0
N533,30,7,6,1,0,23,8,15,0
N530,32,18,11,5,2,14,3,9,2
N531,28,9,8,1,0,19,5,14,0
R538,29,16,11,4,1,13,1,11,1
R539,31,20,11,6,3,11,5,5,1
R532,30,19,11,8,0,11,4,7,0
R533,32,27,14,12,1,5,1,4,0
R530,32,16,12,4,0,16,4,9,3
R531,27,12,7,5,0,15,5,10,0
R536,31,20,12,6,2,11,3,5,3
R537,30,10,5,2,3,20,6,13,1
R534,32,12,7,4,1,20,6,10,4
R535,33,25,13,7,5,8,2,4,2
C544,25,4,2,1,1,21,7,13,1
C545,26,4,4,0,0,22,6,16,0
C546,29,19,10,6,3,10,1,7,2
E592,31,24,15,6,3,7,1,4,2
C540,25,8,5,3,0,17,7,9,1
C541,27,13,8,5,0,14,6,8,0
E597,33,24,15,7,2,9,4,4,1
E596,29,14,8,6,0,15,6,8,1
E599,30,15,9,4,2,15,4,8,3
C553,25,6,6,0,0,19,6,13,0
C548,27,2,1,1,0,25,10,15,0
C549,31,26,20,6,0,5,1,4,0
E569,30,22,13,6,3,8,2,5,1
C559,33,29,18,7,4,4,0,3,1
B741,29,20,10,8,2,9,3,6,0
D593,30,12,5,3,4,18,6,12,0
D590,25,5,4,1,0,20,6,14,0
B742,25,10,7,2,1,15,3,11,1
B745,28,4,3,1,0,24,8,15,1
D597,31,20,15,4,1,11,2,6,3
D594,29,13,8,3,2,16,3,12,1
D595,30,13,7,3,3,17,7,8,2
D844,29,18,12,5,1,11,2,6,3
D845,24,6,4,2,0,18,6,11,1
D598,27,11,7,2,2,16,4,10,2
D599,28,20,12,7,1,8,2,5,1
D840,27,16,12,2,2,11,1,9,1
D841,27,9,6,2,1,18,5,11,2
D842,28,21,12,6,3,7,0,6,1
D843,29,10,6,1,3,19,7,10,2
A578,27,9,7,2,0,18,5,11,2
A577,30,18,11,4,3,12,5,7,0
A576,28,25,7,11,7,3,1,1,1
O584,26,3,0,2,1,23,9,14,0
O585,31,8,3,4,1,23,7,12,4
O586,33,19,8,9,2,14,5,9,0
O587,29,8,6,2,0,21,9,11,1
O580,30,18,13,4,1,12,2,10,0
O581,30,15,9,5,1,15,4,9,2
O582,28,7,5,2,0,21,6,13,2
C738,33,26,13,9,4,7,1,3,3
C737,29,13,8,4,1,16,6,8,2
C736,26,25,14,9,2,1,0,1,0
C734,26,10,5,5,0,16,3,13,0
C733,24,12,9,3,0,12,1,11,0
C732,24,10,7,3,0,14,4,10,0
C731,27,11,8,3,0,16,6,8,2
C730,27,17,10,6,1,10,3,7,0
K599,28,26,15,10,1,2,0,1,1
K598,25,12,8,4,0,13,3,10,0
K593,30,13,7,6,0,17,4,11,2
K592,33,27,16,6,5,6,2,4,0
K590,28,15,10,5,0,13,2,8,3
K597,28,15,12,3,0,13,2,10,1
K596,32,16,8,5,3,16,4,10,2
K595,28,19,13,4,2,9,2,6,1
K594,27,7,5,2,0,20,7,12,1
G739,30,14,9,4,1,16,4,12,0
G738,31,13,11,1,1,18,4,8,6
G733,27,11,5,5,1,16,6,9,1
G732,30,6,5,1,0,24,9,12,3
G731,32,27,16,7,4,5,1,2,2
G730,29,21,10,8,3,8,1,6,1
G737,31,15,11,2,2,16,5,9,2
G736,26,15,10,5,0,11,2,5,4
G734,28,9,6,2,1,19,5,13,1
P790,33,19,10,6,3,14,8,5,1
P791,28,12,9,3,0,16,2,13,1
P792,29,17,8,7,2,12,5,6,1
P793,34,27,16,7,4,7,2,3,2
P794,31,23,14,5,4,8,2,4,2
P795,29,14,9,3,2,15,2,9,4
P796,32,13,11,2,0,19,7,9,3
P797,31,10,5,4,1,21,7,13,1
P798,31,3,3,0,0,28,12,16,0
P799,30,4,2,2,0,26,12,13,1
N701,32,21,15,6,0,11,2,6,3
N700,29,13,8,5,0,16,5,10,1
N703,29,10,8,2,0,19,6,13,0
N702,32,17,12,4,1,15,4,10,1
N705,28,17,8,7,2,11,2,6,3
N704,34,26,11,10,5,8,2,6,0
N707,31,13,6,5,2,18,4,10,4
N706,31,1,1,0,0,30,13,15,2
N709,15,5,3,2,0,10,2,8,0
N708,31,27,14,8,5,4,1,2,1
H682,26,17,10,7,0,9,2,6,1
H683,29,7,6,1,0,22,7,13,2
H680,28,12,7,5,0,16,5,7,4
H681,25,9,5,3,1,16,6,9,1
H686,27,11,7,3,1,16,4,12,0
H687,27,15,10,5,0,12,2,9,1
H684,26,6,3,2,1,20,5,14,1
H685,27,14,7,7,0,13,5,6,2
M692,30,16,8,8,0,14,6,7,1
M693,28,12,6,5,1,16,3,11,2
M690,28,6,5,1,0,22,7,12,3
M694,27,3,1,1,1,24,3,20,1
M695,31,15,10,2,3,16,6,9,1
J562,33,23,11,7,5,10,5,5,0
J565,30,17,8,7,2,13,2,9,2
J564,28,18,9,7,2,10,2,6,2
E784,27,12,5,7,0,15,5,8,2
E785,29,6,3,3,0,23,9,13,1
E786,29,24,17,7,0,5,1,3,1
E787,24,11,7,3,1,13,3,10,0
E780,32,19,13,2,4,13,3,10,0
E781,27,7,6,1,0,20,6,13,1
E782,28,5,4,1,0,23,9,13,1
E783,28,25,12,10,3,3,2,1,0
F597,31,25,17,6,2,6,1,4,1
E788,31,17,12,4,1,14,5,6,3
E789,31,26,16,9,1,5,0,4,1
F598,25,9,5,4,0,16,5,10,1
J568,26,18,8,9,1,8,3,3,2
F848,29,17,10,5,2,12,1,8,3
F849,28,18,13,5,0,10,2,7,1
F842,28,14,9,4,1,14,3,10,1
F843,28,17,13,4,0,11,4,6,1
F840,29,9,5,3,1,20,10,9,1
F841,28,12,10,2,0,16,6,10,0
F846,28,9,9,0,0,19,7,11,1
F847,28,11,8,3,0,17,4,11,2
F844,28,11,8,3,0,17,7,9,1
F845,27,14,9,5,0,13,2,10,1
F590,30,7,3,3,1,23,10,11,2
J560,29,14,6,7,1,15,3,11,1
F592,29,23,14,8,1,6,2,3,1
F593,28,6,5,1,0,22,9,12,1
F594,28,7,4,2,1,21,10,10,1
F595,29,8,5,2,1,21,10,8,3
F596,29,12,8,2,2,17,6,11,0
J566,26,10,8,2,0,16,4,12,0
J569,29,18,12,5,1,11,4,6,1
F599,32,14,9,2,3,18,7,9,2
R709,30,14,7,6,1,16,5,10,1
R708,33,23,14,6,3,10,2,6,2
R705,30,9,5,4,0,21,5,13,3
R704,32,19,11,7,1,13,4,7,2
R707,32,21,11,10,0,11,0,8,3
R706,25,12,8,4,0,13,3,9,1
R701,34,29,15,9,5,5,1,4,0
R700,28,8,5,3,0,20,6,13,1
R703,22,4,4,0,0,18,4,13,1
R702,33,23,14,6,3,10,1,8,1
Q728,31,19,11,8,0,12,6,5,1
Q729,32,12,10,1,1,20,7,11,2
Q726,32,18,11,4,3,14,5,6,3
Q727,28,9,6,3,0,19,7,11,1
Q724,33,27,15,10,2,6,0,4,2
Q725,31,22,15,6,1,9,3,4,2
Q722,32,14,10,2,2,18,4,8,6
Q723,33,20,10,8,2,13,6,4,3
Q720,34,27,18,7,2,7,2,4,1
Q721,31,15,11,1,3,16,5,9,2
Q588,29,3,2,1,0,26,11,15,0
Q589,33,19,9,5,5,14,3,8,3
Q850,30,17,9,7,1,13,2,9,2
Q851,31,12,8,4,0,19,7,11,1
Q580,30,14,9,4,1,16,3,11,2
Q581,31,13,8,5,0,18,4,13,1
Q854,26,17,9,7,1,9,1,8,0
Q587,30,15,10,4,1,15,6,8,1
Q584,25,8,5,3,0,17,6,9,2
Q585,29,13,8,4,1,16,4,11,1
K608,25,12,5,6,1,13,4,8,1
K603,30,21,11,7,3,9,2,6,1
K602,30,23,12,8,3,7,1,5,1
K601,29,17,6,11,0,12,4,7,1
K600,27,18,10,7,1,9,1,6,2
K607,30,27,16,8,3,3,0,2,1
K606,28,11,10,1,0,17,5,11,1
K605,29,7,3,3,1,22,9,11,2
K604,30,15,9,3,3,15,5,7,3
K531,27,10,4,6,0,17,8,7,2
O779,31,11,8,2,1,20,5,12,3
O778,32,17,11,4,2,15,8,7,0
O777,30,11,9,2,0,19,5,14,0
O776,29,11,5,6,0,18,8,10,0
O775,30,14,9,3,2,16,4,10,2
O774,27,5,4,0,1,22,8,13,1
O773,29,5,4,1,0,24,7,14,3
O772,29,16,7,6,3,13,3,7,3
O771,32,20,11,4,5,12,4,6,2
O770,27,18,8,6,4,9,2,6,1
O526,31,14,8,4,2,17,7,9,1
K534,31,18,11,5,2,13,3,9,1
K537,27,3,2,1,0,24,10,14,0
A669,27,20,12,7,1,7,2,5,0
A668,28,15,12,2,1,13,4,8,1
A667,27,13,5,5,3,14,5,8,1
A666,29,22,16,5,1,7,1,6,0
A665,25,9,6,1,2,16,3,12,1
A664,27,15,11,4,0,12,2,9,1
A663,32,31,10,13,8,1,1,0,0
A662,29,17,13,4,0,12,4,6,2
A661,27,16,9,4,3,11,2,8,1
A660,29,22,16,5,1,7,0,5,2
J596,29,13,9,3,1,16,4,10,2
I674,28,13,12,1,0,15,5,9,1
I675,28,25,12,12,1,3,2,0,1
I676,29,16,10,5,1,13,4,6,3
I677,29,15,9,5,1,14,5,8,1
I670,29,18,13,3,2,11,3,7,1
I671,29,18,12,5,1,11,2,6,3
I672,27,15,8,6,1,12,3,8,1
I673,30,12,10,1,1,18,7,10,1
I678,33,19,12,4,3,14,4,8,2
I679,32,21,13,5,3,11,0,10,1
J824,32,25,14,7,4,7,2,4,1
J825,31,19,11,6,2,12,3,8,1
J826,31,15,8,5,2,16,4,9,3
J827,31,18,16,2,0,13,2,7,4
J820,25,12,7,5,0,13,4,9,0
J821,30,25,14,7,4,5,0,3,2
J822,31,24,14,6,4,7,1,5,1
J823,26,14,10,4,0,12,1,11,0
J828,30,24,13,10,1,6,0,6,0
J829,29,22,14,5,3,7,2,3,2
R550,28,6,3,3,0,22,9,12,1
R551,31,13,8,3,2,18,7,9,2
R552,29,11,7,3,1,18,5,13,0
R553,26,11,9,2,0,15,4,11,0
R554,33,24,11,11,2,9,6,2,1
R555,32,11,7,3,1,21,5,16,0
R556,32,21,12,5,4,11,3,7,1
R557,31,23,14,6,3,8,1,7,0
R558,26,10,5,5,0,16,7,9,0
R559,30,20,13,4,3,10,3,5,2
C562,27,18,12,6,0,9,2,7,0
C560,29,21,10,11,0,8,3,5,0
C561,25,8,6,2,0,17,4,9,4
C566,25,1,1,0,0,24,10,14,0
C567,26,7,4,3,0,19,7,10,2
C564,27,11,6,4,1,16,6,9,1
C565,26,10,6,4,0,16,5,11,0
E577,31,27,15,11,1,4,2,0,2
E576,30,13,6,4,3,17,4,11,2
C568,27,18,11,6,1,9,3,5,1
C569,31,20,13,4,3,11,3,6,2
E573,31,20,12,6,2,11,4,5,2
E572,28,6,5,1,0,22,9,12,1
E571,28,6,4,2,0,22,8,12,2
E570,31,24,14,7,3,7,1,6,0
Q541,30,5,3,2,0,25,10,14,1
M577,32,27,15,8,4,5,1,2,2
M576,32,12,7,3,2,20,9,10,1
M575,30,26,13,10,3,4,1,3,0
M574,29,6,5,1,0,23,10,13,0
M573,30,11,7,3,1,19,8,9,2
M572,29,10,9,0,1,19,3,16,0
M571,28,12,5,6,1,16,3,10,3
M570,31,14,7,6,1,17,5,11,1
M579,28,6,4,2,0,22,8,13,1
M578,30,17,11,5,1,13,4,8,1
K854,29,15,8,4,3,14,3,10,1
K855,27,6,4,2,0,21,7,14,0
K852,31,13,8,2,3,18,8,9,1
K853,31,21,14,5,2,10,4,5,1
K850,25,7,4,2,1,18,5,12,1
K851,27,12,9,3,0,15,3,12,0
Q582,30,13,7,6,0,17,4,13,0
Q583,27,11,6,3,2,16,7,8,1
D587,30,21,9,10,2,9,3,4,2
D854,25,3,3,0,0,22,7,12,3
D853,31,21,13,6,2,10,1,7,2
D852,26,17,13,3,1,9,2,7,0
D583,26,12,7,5,0,14,4,9,1
L688,26,3,2,1,0,23,8,15,0
L689,24,16,9,6,1,8,1,7,0
L686,31,11,7,4,0,20,5,15,0
L687,27,14,6,8,0,13,5,7,1
D850,25,9,4,5,0,16,6,9,1
L682,28,10,6,4,0,18,8,10,0
L683,31,13,8,4,1,18,5,12,1
L680,30,15,9,5,1,15,5,7,3
L681,28,9,6,3,0,19,6,12,1
J619,28,5,2,3,0,23,9,13,1
J617,31,18,12,4,2,13,2,9,2
J616,30,24,13,11,0,6,3,3,0
J615,29,21,10,10,1,8,2,5,1
J614,28,11,8,3,0,17,4,11,2
J613,29,16,13,2,1,13,4,8,1
J612,27,12,8,4,0,15,4,10,1
J611,28,8,7,0,1,20,5,13,2
J610,30,17,7,8,2,13,2,9,2
D714,27,9,6,3,0,18,6,11,1
D715,28,15,12,3,0,13,7,6,0
D716,24,9,6,3,0,15,4,11,0
D717,29,14,10,3,1,15,6,8,1
D711,26,4,3,1,0,22,7,14,1
D712,28,10,4,4,2,18,7,10,1
D713,27,19,10,6,3,8,1,7,0
D718,25,10,6,4,0,15,4,11,0
D719,27,17,10,6,1,10,2,7,1
C715,27,10,10,0,0,17,7,10,0
C714,27,10,7,3,0,17,6,11,0
C717,27,13,10,3,0,14,5,8,1
C716,25,11,6,5,0,14,5,9,0
C711,26,5,3,2,0,21,6,15,0
C713,26,19,12,7,0,7,1,6,0
C712,28,14,9,5,0,14,2,12,0
C719,26,5,4,1,0,21,7,12,2
N581,30,6,3,3,0,24,9,12,3
G711,27,13,8,4,1,14,3,10,1
G713,26,12,7,5,0,14,3,10,1
G712,28,7,4,3,0,21,8,11,2
G715,29,16,10,3,3,13,3,8,2
G714,29,14,8,4,2,15,4,9,2
G717,30,20,9,9,2,10,4,4,2
G716,30,12,6,5,1,18,4,12,2
G719,28,17,8,8,1,11,5,5,1
G718,29,16,9,6,1,13,1,9,3
F820,28,13,8,5,0,15,4,10,1
F821,27,16,11,4,1,11,2,7,2
F822,30,25,13,8,4,5,0,4,1
F824,29,21,14,6,1,8,2,6,0
F825,30,16,12,3,1,14,3,9,2
F826,30,22,12,7,3,8,1,3,4
F827,30,15,12,3,0,15,8,7,0
F828,29,12,8,3,1,17,5,11,1
F829,30,18,11,3,4,12,3,8,1
J589,30,15,7,6,2,15,5,8,2
J588,31,19,11,7,1,12,3,7,2
J587,28,11,10,1,0,17,5,10,2
J586,26,7,5,1,1,19,6,13,0
J585,29,7,3,2,2,22,7,13,2
J583,26,7,4,1,2,19,7,11,1
J582,27,7,4,2,1,20,6,13,1
J581,28,10,7,1,2,18,5,12,1
J580,27,19,9,8,2,8,1,7,0
R769,32,14,10,1,3,18,8,9,1
R768,28,16,9,7,0,12,3,6,3
R763,29,7,4,3,0,22,11,9,2
R762,31,15,7,7,1,16,5,8,3
R761,29,11,7,3,1,18,3,14,1
R760,31,14,7,5,2,17,4,12,1
R767,31,14,6,6,2,17,7,7,3
R766,32,8,4,2,2,24,10,12,2
R765,27,23,11,11,1,4,0,3,1
R764,33,15,10,3,2,18,7,9,2
K621,25,11,6,5,0,14,5,7,2
K620,28,3,3,0,0,25,10,15,0
K623,31,25,15,5,5,6,1,4,1
K622,30,16,8,6,2,14,5,7,2
K625,29,18,10,5,3,11,3,7,1
K624,27,8,8,0,0,19,6,12,1
K627,30,23,7,11,5,7,4,2,1
K626,28,12,7,4,1,16,7,8,1
K629,29,15,9,3,3,14,6,6,2
K628,33,25,17,4,4,8,0,7,1
O755,28,10,7,3,0,18,4,10,4
O754,31,23,12,9,2,8,1,7,0
O757,28,19,10,6,3,9,2,7,0
O756,30,13,9,4,0,17,4,12,1
O751,28,21,9,7,5,7,1,6,0
O750,29,14,9,4,1,15,4,11,0
O753,31,10,4,3,3,21,9,8,4
O752,28,8,4,4,0,20,7,10,3
O759,22,7,5,2,0,15,3,11,1
O758,30,9,4,5,0,21,12,8,1
I652,28,14,7,5,2,14,6,7,1
I653,28,1,1,0,0,27,11,13,3
I650,28,13,6,6,1,15,5,9,1
I651,29,20,13,5,2,9,2,5,2
I657,28,18,7,8,3,10,4,6,0
I654,29,9,4,4,1,20,7,12,1
I655,28,18,12,4,2,10,3,6,1
I658,29,24,13,8,3,5,2,3,0
I659,28,6,5,0,1,22,9,12,1
J802,29,9,8,1,0,20,8,10,2
J803,24,8,7,1,0,16,3,13,0
J800,29,11,5,5,1,18,5,9,4
J801,27,9,7,1,1,18,5,10,3
A641,30,6,4,1,1,24,7,10,7
A640,30,28,14,9,5,2,0,0,2
J804,25,10,6,4,0,15,5,10,0
J805,31,21,11,7,3,10,3,5,2
J808,27,8,6,1,1,19,7,12,0
J809,29,21,10,7,4,8,3,5,0
A648,27,8,4,3,1,19,7,12,0
H589,30,19,7,9,3,11,6,4,1
H588,29,15,10,4,1,14,2,11,1
H581,26,12,9,2,1,14,3,10,1
H580,24,7,4,3,0,17,6,11,0
H583,25,10,6,3,1,15,6,9,0
H582,29,17,8,7,2,12,2,8,2
H585,25,10,4,6,0,15,6,9,0
H587,28,12,9,3,0,16,5,10,1
H586,27,17,8,5,4,10,2,8,0
R578,30,8,6,2,0,22,9,12,1
R579,31,11,5,4,2,20,8,11,1
R576,31,13,5,7,1,18,8,7,3
R577,32,27,16,5,6,5,0,4,1
R574,30,18,11,7,0,12,2,9,1
R575,31,14,8,4,2,17,6,7,4
R572,30,21,13,8,0,9,2,6,1
R573,32,11,7,4,0,21,10,8,3
R570,33,19,9,8,2,14,4,7,3
R571,31,13,6,5,2,18,3,12,3
E555,27,11,4,5,2,16,6,8,2
E554,26,20,11,7,2,6,1,3,2
E557,29,17,9,5,3,12,3,7,2
E556,30,17,12,2,3,13,2,10,1
E551,30,10,8,2,0,20,11,9,0
E550,25,6,2,3,1,19,8,7,4
E553,28,10,6,4,0,18,5,12,1
E552,29,15,9,6,0,14,5,7,2
E559,33,24,13,6,5,9,3,5,1
E558,26,12,5,5,2,14,5,7,2
C508,25,10,7,3,0,15,3,12,0
C509,27,8,6,1,1,19,6,12,1
C502,21,5,3,2,0,16,6,10,0
C503,26,16,10,6,0,10,3,7,0
C504,30,15,8,4,3,15,6,7,2
C506,26,9,6,3,0,17,5,12,0
G504,33,26,17,4,5,7,0,4,3
G505,27,17,10,7,0,10,2,7,1
G506,30,18,11,5,2,12,1,8,3
G507,28,8,5,3,0,20,7,12,1
G502,28,9,5,2,2,19,6,12,1
G503,30,9,5,3,1,21,7,9,5
G508,29,20,10,8,2,9,0,9,0
G509,30,18,8,8,2,12,6,6,0
M559,32,24,16,7,1,8,1,4,3
M558,28,13,6,6,1,15,6,9,0
M555,32,18,9,8,1,14,5,9,0
M554,33,16,9,4,3,17,4,10,3
M557,30,6,2,0,4,24,9,14,1
M556,31,11,5,3,3,20,9,10,1
M551,32,23,14,6,3,9,2,5,2
M550,26,2,2,0,0,24,10,12,2
M553,25,10,8,2,0,15,3,12,0
M552,31,19,10,6,3,12,3,8,1
Q681,27,10,5,5,0,17,6,11,0
Q680,29,23,14,9,0,6,2,4,0
Q683,29,9,4,5,0,20,7,10,3
Q682,30,15,7,6,2,15,4,9,2
Q685,33,21,9,8,4,12,0,11,1
Q687,28,27,11,12,4,1,1,0,0
Q686,29,8,4,4,0,21,9,12,0
Q689,29,16,9,5,2,13,4,8,1
Q688,26,8,4,2,2,18,8,10,0
G575,29,14,9,4,1,15,4,10,1
G574,30,18,11,7,0,12,1,8,3
I793,30,23,15,6,2,7,1,3,3
I792,25,10,8,2,0,15,4,11,0
I791,26,6,4,2,0,20,6,14,0
I790,28,15,14,1,0,13,3,9,1
I797,26,8,6,1,1,18,4,13,1
I796,32,22,15,4,3,10,1,7,2
I795,23,9,5,3,1,14,3,8,3
I794,28,7,5,2,0,21,9,11,1
I799,29,8,5,2,1,21,8,12,1
I798,31,20,11,8,1,11,1,9,1
O595,31,22,13,6,3,9,3,5,1
J635,28,6,4,2,0,22,9,12,1
G579,28,12,7,4,1,16,3,11,2
J637,27,15,11,2,2,12,5,6,1
J636,29,23,15,6,2,6,1,4,1
J631,27,14,7,5,2,13,4,8,1
J630,28,6,5,0,1,22,5,16,1
J633,27,14,7,6,1,13,4,7,2
G578,28,9,7,2,0,19,6,12,1
J639,30,18,11,5,2,12,2,9,1
D800,25,7,4,3,0,18,5,8,5
B784,23,7,5,2,0,16,7,9,0
D802,31,22,13,5,4,9,1,6,2
B786,31,19,9,7,3,12,6,4,2
B781,28,21,12,7,2,7,2,5,0
B780,29,11,9,2,0,18,10,8,0
B783,25,18,12,5,1,7,0,6,1
D807,24,4,4,0,0,20,7,13,0
D809,27,17,9,5,3,10,1,7,2
B789,29,19,12,6,1,10,4,6,0
B788,33,21,13,2,6,12,3,6,3
O599,30,16,8,7,1,14,6,8,0
O598,28,11,6,4,1,17,6,9,2
D732,25,7,5,1,1,18,6,10,2
D733,26,15,11,2,2,11,1,8,2
D730,29,17,11,5,1,12,3,6,3
D731,30,14,9,2,3,16,5,10,1
D736,26,19,7,8,4,7,2,4,1
D737,29,16,10,6,0,13,7,5,1
D734,25,5,2,3,0,20,7,13,0
D738,31,19,12,5,2,12,4,6,2
D739,26,8,4,4,0,18,7,11,0
C773,25,12,8,4,0,13,2,11,0
C772,32,22,11,6,5,10,3,5,2
C771,30,17,9,6,2,13,6,5,2
C777,26,16,9,7,0,10,6,4,0
C776,26,14,8,6,0,12,4,8,0
C775,31,17,10,3,4,14,3,9,2
C774,25,5,4,1,0,20,7,13,0
C779,28,11,4,3,4,17,5,10,2
C778,30,21,12,8,1,9,5,3,1
K559,30,27,16,8,3,3,0,2,1
K558,26,10,6,4,0,16,6,9,1
K557,29,14,7,5,2,15,6,7,2
K556,29,20,14,4,2,9,1,7,1
K555,28,9,5,2,2,19,6,11,2
K554,26,15,9,5,1,11,5,6,0
K553,26,16,10,5,1,10,1,9,0
K552,26,8,4,4,0,18,10,8,0
K551,29,17,11,4,2,12,4,7,1
K550,27,6,2,3,1,21,10,10,1
F808,24,7,4,3,0,17,7,10,0
F809,29,7,4,2,1,22,8,11,3
F807,28,24,14,10,0,4,2,2,0
F804,29,7,4,3,0,22,6,13,3
F805,31,17,10,6,1,14,5,7,2
F802,32,21,15,4,2,11,3,8,0
F803,25,8,5,2,1,17,2,14,1
F800,30,18,8,6,4,12,3,8,1
F801,28,7,7,0,0,21,7,11,3
R741,29,8,5,3,0,21,10,9,2
R740,29,10,5,4,1,19,5,12,2
R743,32,18,15,3,0,14,2,10,2
R742,29,4,4,0,0,25,10,11,4
R745,33,23,12,10,1,10,3,6,1
R744,32,18,9,7,2,14,5,8,1
R747,28,4,4,0,0,24,8,15,1
R746,31,15,9,4,2,16,7,8,1
R749,30,13,8,4,1,17,4,11,2
R748,31,22,11,7,4,9,0,9,0
O733,30,11,6,5,0,19,4,12,3
O732,29,19,11,5,3,10,2,6,2
O731,32,24,17,5,2,8,1,4,3
O730,29,6,4,0,2,23,10,12,1
O737,31,12,8,4,0,19,9,9,1
O736,27,19,9,10,0,8,3,5,0
O735,30,4,2,1,1,26,7,18,1
O734,26,12,7,5,0,14,3,10,1
O739,32,23,14,8,1,9,1,8,0
O738,32,27,14,8,5,5,2,2,1
I639,29,21,10,8,3,8,2,5,1
I630,26,2,2,0,0,24,6,16,2
I631,30,19,7,8,4,11,4,6,1
I632,29,12,8,3,1,17,1,14,2
I633,26,11,7,4,0,15,5,8,2
I634,26,12,10,2,0,14,2,12,0
I635,28,7,5,2,0,21,8,12,1
I636,28,20,12,5,3,8,1,5,2
I637,28,14,12,2,0,14,4,9,1
J792,26,15,10,4,1,11,0,9,2
J793,29,19,14,4,1,10,2,6,2
J790,31,14,10,2,2,17,6,8,3
J791,28,12,8,2,2,16,1,15,0
J796,30,20,13,5,2,10,2,5,3
J797,25,4,1,3,0,21,7,11,3
J794,26,17,14,3,0,9,2,6,1
J795,24,10,6,4,0,14,3,11,0
J798,28,15,10,3,2,13,1,10,2
J799,29,5,3,1,1,24,10,13,1
A768,26,11,9,0,2,15,3,10,2
A769,28,17,14,2,1,11,1,8,2
A623,30,18,11,5,2,12,5,6,1
A622,27,9,7,1,1,18,4,12,2
A621,24,9,5,3,1,15,4,8,3
A620,26,10,6,1,3,16,4,9,3
A627,28,21,12,8,1,7,1,4,2
A626,26,10,8,2,0,16,5,11,0
A625,29,18,13,5,0,11,3,6,2
A624,30,19,9,8,2,11,4,5,2
A629,30,22,12,8,2,8,3,4,1
A628,30,22,14,6,2,8,1,6,1
A764,28,12,11,1,0,16,6,10,0
A765,26,15,7,5,3,11,3,6,2
C698,31,20,13,5,2,11,2,8,1
C699,27,15,10,5,0,12,4,8,0
C690,25,9,5,3,1,16,6,9,1
C692,27,17,11,6,0,10,2,8,0
C693,25,7,5,2,0,18,7,11,0
C695,30,16,12,3,1,14,6,7,1
C696,23,4,3,1,0,19,6,13,0
G695,32,22,14,6,2,10,4,5,1
G690,28,12,6,5,1,16,6,9,1
G692,29,9,7,2,0,20,6,10,4
G693,27,10,6,4,0,17,4,11,2
G698,28,13,12,1,0,15,4,10,1
G699,29,16,9,6,1,13,4,8,1
C526,28,15,12,2,1,13,0,11,2
C527,30,14,9,5,0,16,7,7,2
E531,27,8,6,2,0,19,7,12,0
E530,30,14,12,2,0,16,2,11,3
E537,28,5,3,2,0,23,10,12,1
E536,29,19,11,6,2,10,2,8,0
E535,30,23,13,6,4,7,0,7,0
E534,28,5,4,1,0,23,9,13,1
E539,30,16,10,4,2,14,7,6,1
E538,25,7,4,3,0,18,9,9,0
C528,30,19,12,6,1,11,2,8,1
C529,25,9,6,2,1,16,5,11,0
G522,28,11,7,3,1,17,5,11,1
G523,29,12,6,5,1,17,7,9,1
G520,31,20,11,6,3,11,2,6,3
G521,28,12,11,0,1,16,4,10,2
G526,29,12,8,3,1,17,6,11,0
G527,31,20,11,5,4,11,5,4,2
G524,28,9,4,4,1,19,8,9,2
G525,25,11,8,3,0,14,3,9,2
G528,31,22,10,9,3,9,2,6,1
G529,31,23,12,7,4,8,1,5,2
E575,29,11,9,1,1,18,5,13,0
E574,30,18,13,4,1,12,0,9,3
M539,31,16,10,5,1,15,8,6,1
M538,29,11,6,4,1,18,5,11,2
M533,31,12,7,4,1,19,6,12,1
M531,28,19,9,10,0,9,3,6,0
M530,32,17,10,6,1,15,6,7,2
M537,29,13,7,5,1,16,3,12,1
M536,34,27,16,8,3,7,0,5,2
M535,32,29,14,11,4,3,1,2,0
M534,29,9,7,1,1,20,6,12,2
C834,25,14,10,4,0,11,2,9,0
C835,29,10,6,4,0,19,8,11,0
C836,27,20,11,8,1,7,2,5,0
C830,30,11,7,2,2,19,7,10,2
C831,27,10,8,2,0,17,6,8,3
C832,24,11,6,5,0,13,4,9,0
C833,24,9,6,3,0,15,5,9,1
C838,28,12,8,3,1,16,4,12,0
C839,28,15,11,3,1,13,5,8,0
Q669,29,8,7,1,0,21,7,14,0
Q668,31,19,13,5,1,12,3,8,1
Q667,32,21,12,9,0,11,3,8,0
Q666,34,26,18,7,1,8,2,4,2
Q665,29,6,4,2,0,23,6,14,3
Q664,29,14,6,6,2,15,4,10,1
Q663,33,22,15,4,3,11,1,7,3
Q662,32,17,13,1,3,15,4,8,3
Q661,33,20,12,5,3,13,4,8,1
Q660,32,25,15,6,4,7,1,5,1
J653,28,6,5,1,0,22,8,12,2
J652,28,11,6,4,1,17,6,10,1
J651,31,27,15,9,3,4,2,1,1
J650,29,14,8,5,1,15,4,9,2
J657,28,13,6,6,1,15,4,9,2
J655,29,20,14,4,2,9,1,6,2
J654,29,12,6,5,1,17,6,11,0
J659,28,11,7,4,0,17,6,10,1
J658,27,13,9,3,1,14,2,11,1
D538,25,9,6,3,0,16,6,8,2
D539,28,17,13,4,0,11,3,8,0
D828,27,11,7,2,2,16,5,9,2
D829,30,20,13,3,4,10,2,7,1
D826,29,21,11,8,2,8,1,6,1
D827,29,14,13,1,0,15,3,11,1
D536,28,12,9,2,1,16,5,10,1
D537,25,9,6,3,0,16,5,11,0
D822,25,12,10,2,0,13,2,9,2
D531,26,4,3,1,0,22,9,12,1
D820,26,16,7,7,2,10,3,7,0
D821,29,25,12,8,5,4,0,2,2
L534,31,12,8,2,2,19,7,11,1
L535,31,25,14,8,3,6,2,4,0
L536,32,24,16,6,2,8,0,7,1
L537,31,13,6,5,2,18,7,9,2
L530,32,20,12,5,3,12,3,7,2
L531,29,11,6,4,1,18,4,12,2
L533,31,22,10,11,1,9,2,6,1
D751,25,9,5,4,0,16,5,11,0
D752,27,22,7,11,4,5,3,2,0
D753,25,16,9,6,1,9,2,5,2
L538,28,17,10,5,2,11,2,7,2
D755,29,11,7,3,1,18,6,10,2
D756,27,11,9,2,0,16,3,11,2
D757,26,14,7,6,1,12,5,6,1
K575,29,10,6,3,1,19,8,9,2
C758,28,18,10,6,2,10,4,5,1
K577,33,30,14,10,6,3,1,2,0
K576,31,15,11,4,0,16,3,9,4
K571,33,20,9,9,2,13,1,9,3
K570,30,9,4,2,3,21,8,12,1
K573,27,12,7,4,1,15,7,8,0
K572,31,16,10,3,3,15,2,12,1
C751,26,9,7,2,0,17,3,13,1
C753,26,12,7,5,0,14,3,11,0
C752,25,12,10,2,0,13,1,10,2
K579,27,6,3,3,0,21,9,12,0
K578,27,3,2,1,0,24,13,11,0
C757,24,5,3,2,0,19,9,10,0
C756,26,3,3,0,0,23,10,12,1
H628,29,16,11,5,0,13,6,6,1
H629,28,15,12,2,1,13,4,8,1
H624,29,8,5,2,1,21,9,11,1
H625,32,20,11,2,7,12,1,9,2
H626,31,7,5,0,2,24,9,12,3
H627,29,17,10,4,3,12,2,8,2
H620,27,12,7,5,0,15,6,8,1
H621,27,13,7,3,3,14,2,10,2
H622,29,21,11,9,1,8,2,6,0
H623,30,24,14,3,7,6,0,6,0
J598,25,12,8,4,0,13,2,8,3
F586,25,15,8,7,0,10,2,7,1
P624,31,12,10,2,0,19,8,10,1
P625,32,12,12,0,0,20,6,11,3
P626,32,19,9,6,4,13,3,8,2
P627,33,22,11,9,2,11,2,6,3
P620,30,17,9,8,0,13,5,7,1
P621,27,7,5,1,1,20,5,14,1
P622,30,6,3,1,2,24,9,14,1
P623,32,19,14,3,2,13,2,7,4
P628,31,11,8,2,1,20,8,9,3
P629,32,16,13,2,1,16,6,9,1
J597,29,15,9,5,1,14,6,7,1
C786,32,24,12,9,3,8,4,2,2
F680,25,9,8,1,0,16,5,11,0
F681,29,15,11,3,1,14,3,9,2
F682,26,10,5,5,0,16,7,9,0
F683,29,6,2,2,2,23,7,14,2
F684,23,3,2,1,0,20,4,16,0
F685,25,16,11,5,0,9,1,8,0
F686,28,7,5,2,0,21,7,13,1
F687,28,16,10,6,0,12,2,9,1
L708,34,28,16,6,6,6,1,4,1
L707,30,11,7,3,1,19,4,12,3
L706,29,5,3,2,0,24,9,13,2
L705,29,7,5,2,0,22,4,16,2
L704,33,22,9,9,4,11,6,4,1
L703,30,13,8,5,0,17,5,8,4
L702,32,24,18,6,0,8,1,7,0
L701,31,14,12,1,1,17,5,10,2
L700,29,10,4,5,1,19,6,12,1
O719,34,20,12,5,3,14,4,9,1
O718,32,24,11,10,3,8,1,7,0
O711,30,22,10,9,3,8,2,6,0
O710,30,12,4,5,3,18,7,10,1
O713,26,12,6,6,0,14,4,10,0
O712,32,20,9,8,3,12,4,5,3
O715,33,20,15,2,3,13,4,8,1
O714,32,28,14,9,5,4,0,3,1
O717,34,23,17,3,3,11,3,6,2
O716,25,7,4,3,0,18,6,12,0
A546,29,14,9,5,0,15,3,8,4
G849,29,17,12,5,0,12,1,8,3
G848,28,17,7,7,3,11,4,5,2
A547,25,13,9,4,0,12,4,7,1
G845,26,13,8,4,1,13,4,8,1
G844,30,9,5,2,2,21,8,12,1
G847,28,9,6,3,0,19,4,13,2
G846,30,15,11,3,1,15,3,9,3
G841,27,6,6,0,0,21,9,12,0
A544,27,12,8,3,1,15,3,11,1
G843,27,7,4,2,1,20,8,9,3
G842,27,16,8,3,5,11,3,7,1
A545,26,13,5,7,1,13,5,7,1
A811,26,14,10,3,1,12,2,9,1
A812,28,15,7,6,2,13,3,9,1
A541,29,19,8,7,4,10,3,6,1
I616,27,13,9,4,0,14,2,10,2
I617,27,9,8,1,0,18,9,9,0
I614,28,17,9,8,0,11,3,8,0
I615,29,14,8,6,0,15,3,11,1
I612,27,4,2,2,0,23,10,13,0
I613,29,18,13,4,1,11,3,6,2
I610,30,13,7,5,1,17,4,9,4
I611,28,11,6,3,2,17,5,10,2
I619,28,6,2,4,0,22,11,9,2
J846,29,20,11,8,1,9,3,5,1
J847,29,8,6,1,1,21,8,12,1
J844,27,16,9,7,0,11,4,6,1
L685,33,18,10,6,2,15,1,11,3
J842,29,13,9,4,0,16,3,12,1
J843,31,21,11,6,4,10,3,5,2
J840,31,26,14,6,6,5,0,5,0
J841,28,12,5,5,2,16,5,9,2
J848,29,24,13,9,2,5,0,4,1
J849,30,22,15,5,2,8,1,6,1
A608,26,10,3,4,3,16,7,7,2
A600,25,2,1,1,0,23,9,12,2
A603,31,24,15,5,4,7,0,5,2
A602,26,10,7,3,0,16,5,11,0
A605,25,10,7,3,0,15,4,11,0
A604,28,19,14,4,1,9,1,7,1
A607,27,19,9,6,4,8,2,5,1
A606,33,22,13,7,2,11,1,7,3
P819,25,9,5,4,0,16,4,12,0
P818,33,19,12,5,2,14,4,8,2
P817,32,24,12,8,4,8,5,3,0
P816,31,13,9,3,1,18,6,11,1
P815,31,7,3,3,1,24,12,11,1
P814,29,16,7,7,2,13,5,8,0
P813,30,5,3,2,0,25,10,14,1
P812,29,5,2,2,1,24,9,13,2
P811,27,13,9,4,0,14,3,10,1
P810,32,22,16,5,1,10,2,5,3
E519,26,16,8,7,1,10,3,7,0
E518,31,22,16,2,4,9,1,6,2
E511,32,26,16,7,3,6,1,4,1
E510,28,20,8,8,4,8,1,6,1
E513,28,4,4,0,0,24,11,13,0
E512,29,17,13,4,0,12,3,7,2
E515,33,19,11,3,5,14,5,8,1
E514,25,5,3,2,0,20,6,14,0
E517,26,3,2,1,0,23,9,13,1
E516,28,10,6,3,1,18,6,11,1
G548,27,1,1,0,0,26,10,15,1
G549,33,30,15,8,7,3,0,3,0
G540,26,7,6,1,0,19,6,13,0
G541,30,10,6,2,2,20,7,11,2
G543,23,10,7,2,1,13,2,11,0
G544,31,27,13,11,3,4,2,2,0
G545,27,10,6,3,1,17,3,13,1
G546,29,18,11,6,1,11,3,6,2
G547,28,14,10,3,1,14,2,9,3
M511,32,18,10,6,2,14,6,7,1
M510,30,17,8,7,2,13,4,7,2
M513,29,18,11,6,1,11,3,7,1
M512,31,19,13,4,2,12,4,6,2
M515,33,22,15,2,5,11,1,7,3
M514,29,11,4,6,1,18,6,11,1
M517,30,14,7,7,0,16,7,9,0
M516,28,8,7,1,0,20,6,14,0
M519,34,24,13,8,3,10,1,8,1
M518,30,14,8,4,2,16,7,7,2
C812,28,12,7,5,0,16,4,10,2
C813,25,11,5,6,0,14,5,9,0
C810,29,21,14,6,1,8,2,5,1
C811,30,17,12,5,0,13,4,7,2
C816,30,20,9,7,4,10,0,10,0
C817,31,19,15,4,0,12,4,8,0
C814,26,17,11,6,0,9,1,7,1
C815,28,9,5,4,0,19,6,12,1
C818,28,9,6,3,0,19,7,12,0
C819,27,11,5,6,0,16,5,11,0
Q645,29,11,6,5,0,18,8,9,1
Q644,32,25,11,12,2,7,1,6,0
Q647,31,23,10,8,5,8,0,7,1
Q646,30,12,5,5,2,18,7,11,0
Q641,33,21,15,6,0,12,3,8,1
Q640,34,32,18,8,6,2,0,1,1
Q643,32,21,10,8,3,11,2,9,0
Q642,31,13,6,7,0,18,7,11,0
Q649,27,6,3,2,1,21,5,14,2
Q648,33,25,15,7,3,8,0,8,0
J679,29,16,9,7,0,13,5,8,0
J678,30,18,12,4,2,12,3,8,1
J671,28,22,14,6,2,6,1,3,2
J670,31,13,11,2,0,18,7,8,3
J673,31,21,14,5,2,10,3,4,3
J672,29,17,9,5,3,12,3,7,2
J675,32,22,11,5,6,10,2,5,3
J674,31,14,8,3,3,17,6,8,3
J677,26,14,7,7,0,12,4,7,1
J676,32,16,14,1,1,16,4,8,4
D518,30,27,15,10,2,3,0,2,1
D519,27,11,8,3,0,16,4,12,0
D512,28,12,9,3,0,16,7,7,2
D513,26,11,8,2,1,15,3,10,2
D510,26,18,9,7,2,8,2,5,1
D511,28,22,15,5,2,6,0,6,0
D516,29,18,9,6,3,11,3,8,0
D517,25,6,5,1,0,19,3,16,0
D514,25,2,1,1,0,23,9,14,0
D515,32,22,14,4,4,10,2,6,2
D776,27,19,9,9,1,8,1,6,1
D777,26,9,8,1,0,17,4,13,0
D774,28,11,7,4,0,17,3,8,6
D775,29,14,8,5,1,15,4,9,2
D772,30,14,8,4,2,16,6,8,2
D773,26,19,12,6,1,7,1,6,0
D771,28,14,6,6,2,14,7,6,1
D778,33,25,17,8,0,8,6,2,0
D779,29,11,7,2,2,18,4,9,5
L512,29,7,6,1,0,22,11,10,1
L513,29,12,6,5,1,17,6,11,0
L510,29,22,9,9,4,7,1,5,1
L511,30,20,11,7,2,10,5,4,1
L516,31,16,9,5,2,15,2,10,3
L517,29,13,8,3,2,16,4,12,0
L514,29,10,6,3,1,19,3,15,1
L515,34,21,13,2,6,13,3,8,2
L518,31,16,14,2,0,15,5,7,3
L519,30,19,11,7,1,11,2,8,1
K513,28,13,8,3,2,15,6,7,2
K512,28,11,8,3,0,17,9,7,1
K511,31,19,12,4,3,12,2,7,3
K510,28,12,6,4,2,16,4,10,2
O508,31,2,2,0,0,29,8,18,3
K516,28,10,6,2,2,18,5,12,1
K515,31,22,15,3,4,9,1,5,3
K514,27,11,4,5,2,16,5,10,1
O504,32,17,11,3,3,15,6,6,3
O505,23,8,5,3,0,15,4,9,2
O506,28,13,6,6,1,15,3,11,1
O507,32,7,4,3,0,25,9,15,1
O502,29,8,6,0,2,21,9,10,2
O503,33,23,12,7,4,10,4,4,2
H608,28,10,7,3,0,18,2,14,2
H602,28,16,10,6,0,12,3,8,1
H603,29,15,11,3,1,14,6,7,1
H600,26,13,6,6,1,13,5,7,1
H601,28,4,3,1,0,24,7,14,3
H606,28,14,12,1,1,14,3,10,1
H607,31,23,11,9,3,8,2,2,4
H604,27,19,12,5,2,8,1,6,1
H605,28,13,8,5,0,15,6,7,2
P602,32,26,14,10,2,6,0,3,3
P603,31,21,10,7,4,10,4,5,1
P600,29,2,2,0,0,27,10,14,3
P601,30,9,4,3,2,21,5,16,0
P606,31,13,10,1,2,18,6,10,2
P607,32,23,13,6,4,9,3,4,2
P604,32,21,12,7,2,11,4,4,3
P605,31,12,8,2,2,19,6,12,1
P608,33,12,4,5,3,21,6,13,2
N789,33,22,9,9,4,11,2,8,1
N788,30,13,9,3,1,17,5,10,2
N781,30,24,11,8,5,6,1,3,2
N780,31,17,13,2,2,14,3,9,2
N783,31,18,13,4,1,13,4,8,1
N782,30,11,7,4,0,19,6,11,2
N785,29,15,6,9,0,14,7,7,0
N784,28,11,8,3,0,17,4,12,1
N787,30,15,6,6,3,15,3,11,1
N786,34,25,15,5,5,9,3,5,1
R785,30,23,10,12,1,7,1,6,0
R784,30,14,7,6,1,16,6,9,1
R787,28,5,3,2,0,23,9,14,0
R786,35,26,17,5,4,9,2,5,2
R781,32,26,15,9,2,6,1,2,3
R780,33,27,17,6,4,6,2,3,1
R783,32,18,11,5,2,14,5,6,3
R782,30,9,5,4,0,21,8,11,2
R789,32,23,14,8,1,9,3,4,2
R788,31,10,8,1,1,21,9,10,2
J561,26,12,6,6,0,14,4,9,1
E708,31,18,9,6,3,13,5,5,3
E704,29,17,10,6,1,12,2,10,0
E705,26,9,5,4,0,17,5,11,1
E707,28,12,4,8,0,16,5,8,3
E700,28,3,2,1,0,25,10,13,2
E701,29,16,11,5,0,13,7,5,1
E702,30,21,12,7,2,9,2,6,1
E703,29,11,7,2,2,18,6,10,2
M704,29,19,10,8,1,10,2,7,1
M705,30,9,5,3,1,21,5,15,1
M706,29,0,0,0,0,29,12,15,2
M707,31,16,9,6,1,15,1,13,1
M700,28,8,5,3,0,20,9,10,1
M701,32,24,16,8,0,8,2,5,1
M702,34,20,15,5,0,14,4,8,2
M703,30,17,6,9,2,13,7,5,1
M708,34,32,14,13,5,2,2,0,0
K683,30,4,2,2,0,26,9,14,3
K682,26,3,1,2,0,23,10,13,0
K681,27,13,10,3,0,14,4,7,3
K680,27,21,11,8,2,6,1,5,0
K687,29,23,13,8,2,6,1,4,1
K686,30,13,7,5,1,17,6,9,2
K685,27,9,5,4,0,18,4,9,5
M854,27,12,7,5,0,15,5,10,0
M855,28,7,4,2,1,21,7,14,0
K689,24,12,8,2,2,12,1,11,0
K688,27,3,3,0,0,24,7,14,3
M850,28,12,5,4,3,16,5,10,1
M851,31,21,13,7,1,10,3,6,1
M852,28,10,6,3,1,18,6,10,2
M853,33,27,16,7,4,6,1,4,1
L725,33,26,16,6,4,7,2,5,0
L724,32,22,11,6,5,10,2,8,0
L727,30,11,5,4,2,19,6,10,3
L726,31,10,7,3,0,21,11,9,1
L721,30,15,12,1,2,15,4,8,3
L720,33,30,19,7,4,3,0,3,0
L723,32,24,15,8,1,8,2,5,1
L722,33,21,14,0,7,12,2,8,2
L729,30,11,11,0,0,19,8,10,1
L728,29,21,11,9,1,8,3,4,1
G829,29,17,13,2,2,12,4,7,1
G828,29,21,10,8,3,8,1,5,2
G822,29,22,13,7,2,7,1,5,1
G821,27,19,12,6,1,8,2,5,1
G820,29,19,10,7,2,10,2,8,0
G827,30,16,12,2,2,14,4,8,2
G826,31,24,10,8,6,7,1,5,1
G825,32,21,13,4,4,11,1,8,2
G824,31,9,8,0,1,22,7,12,3
C658,29,12,9,3,0,17,5,12,0
C659,28,11,9,2,0,17,5,12,0
C654,26,12,10,2,0,14,2,11,1
C655,26,8,7,1,0,18,8,9,1
C657,25,5,4,1,0,20,7,12,1
C650,27,12,10,2,0,15,4,10,1
C651,32,12,6,3,3,20,8,10,2
C652,27,7,5,2,0,20,8,12,0
C653,27,11,7,4,0,16,5,11,0
D849,31,22,11,8,3,9,2,5,2
P835,32,16,7,6,3,16,6,7,3
P834,27,4,2,1,1,23,9,13,1
P836,31,19,10,7,2,12,4,6,2
P831,32,21,11,4,6,11,3,6,2
P830,31,16,11,4,1,15,6,6,3
P833,32,17,10,6,1,15,1,11,3
P832,27,14,7,7,0,13,5,7,1
P839,32,8,7,0,1,24,12,10,2
P838,30,13,8,5,0,17,5,12,0
O852,29,8,7,0,1,21,9,11,1
O853,32,24,15,7,2,8,0,5,3
O850,33,25,10,10,5,8,1,6,1
O851,32,20,12,5,3,12,1,11,0
O854,30,11,5,4,2,19,6,10,3
O855,28,6,4,2,0,22,9,13,0
G566,26,7,7,0,0,19,5,12,2
G567,26,8,3,4,1,18,9,9,0
G564,26,4,3,1,0,22,9,13,0
G565,27,11,6,5,0,16,6,9,1
G562,30,22,12,7,3,8,3,5,0
G560,30,5,2,1,2,25,7,12,6
G561,26,4,3,1,0,22,8,13,1
G568,27,18,8,7,3,9,2,5,2
G569,30,20,12,5,3,10,3,6,1
Q623,32,17,13,2,2,15,4,8,3
Q622,28,7,6,1,0,21,6,15,0
Q621,29,8,4,4,0,21,8,13,0
Q620,29,16,9,7,0,13,4,7,2
Q627,32,25,10,11,4,7,1,4,2
Q626,31,17,10,4,3,14,3,9,2
Q625,33,25,18,5,2,8,1,6,1
Q624,33,20,14,3,3,13,3,8,2
Q629,32,22,16,4,2,10,2,7,1
Q628,33,17,13,3,1,16,6,8,2
G586,25,15,9,6,0,10,1,8,1
D570,30,25,14,10,1,5,1,4,0
D571,26,7,4,2,1,19,6,11,2
D572,27,10,7,3,0,17,5,12,0
D573,29,17,10,6,1,12,3,9,0
D574,28,23,10,9,4,5,1,4,0
D575,26,9,8,0,1,17,5,12,0
D576,29,20,10,7,3,9,1,6,2
D577,33,32,15,10,7,1,0,0,1
D578,27,4,3,1,0,23,9,10,4
D579,28,12,8,4,0,16,4,11,1
G581,29,5,3,1,1,24,11,11,2
G582,28,15,6,6,3,13,3,8,2
G583,28,10,8,0,2,18,5,12,1
D798,25,17,12,5,0,8,1,7,0
D799,28,6,4,1,1,22,9,13,0
D794,27,12,9,3,0,15,5,10,0
D795,26,17,7,9,1,9,3,4,2
D796,30,13,10,2,1,17,5,9,3
D797,23,5,3,2,0,18,7,11,0
D790,28,20,14,6,0,8,1,5,2
D791,25,10,5,4,1,15,6,9,0
D792,25,10,7,3,0,15,4,11,0
D793,31,19,8,9,2,12,5,5,2
L578,29,10,5,5,0,19,9,9,1
L579,29,9,6,3,0,20,7,11,2
L570,31,5,3,1,1,26,11,13,2
L571,32,20,8,9,3,12,1,9,2
L572,29,4,4,0,0,25,10,15,0
L573,30,17,13,4,0,13,2,8,3
L574,30,11,6,4,1,19,6,13,0
L575,31,16,10,2,4,15,4,8,3
L576,30,22,8,13,1,8,3,4,1
L577,32,22,15,5,2,10,4,4,2
K539,30,20,12,6,2,10,3,4,3
K538,27,8,4,3,1,19,7,11,1
O528,32,19,9,8,2,13,4,7,2
O529,29,13,8,5,0,16,5,11,0
O522,31,19,10,8,1,12,3,8,1
O523,30,14,7,4,3,16,4,11,1
O520,29,14,10,4,0,15,6,8,1
O521,31,24,14,6,4,7,1,4,2
K535,31,19,11,5,3,12,1,9,2
O527,31,15,11,3,1,16,6,7,3
O524,29,11,8,3,0,18,3,12,3
K536,27,19,13,4,2,8,1,6,1
H660,28,23,15,7,1,5,1,3,1
H661,28,13,10,3,0,15,3,10,2
H662,28,19,14,4,1,9,2,4,3
H663,28,10,8,2,0,18,7,9,2
H664,27,13,8,5,0,14,3,11,0
H665,28,5,3,2,0,23,9,13,1
H666,29,23,14,7,2,6,2,4,0
H667,28,22,10,11,1,6,2,4,0
H668,28,11,9,2,0,17,5,10,2
H669,27,12,8,4,0,15,4,9,2
G799,29,11,6,4,1,18,6,10,2
G798,30,16,11,4,1,14,2,11,1
G791,26,9,7,2,0,17,3,14,0
G790,30,14,10,3,1,16,4,9,3
G793,31,20,10,7,3,11,5,3,3
G792,27,21,11,9,1,6,1,5,0
G795,27,11,6,5,0,16,5,11,0
G794,30,8,4,3,1,22,9,9,4
G797,25,11,6,3,2,14,4,9,1
G796,31,23,15,6,2,8,2,5,1
P668,33,19,11,4,4,14,4,8,2
P669,31,15,11,4,0,16,4,11,1
P660,34,20,14,4,2,14,4,7,3
P661,31,20,12,6,2,11,3,8,0
P662,33,19,14,4,1,14,4,6,4
P663,29,14,7,4,3,15,8,6,1
P664,28,17,11,4,2,11,1,9,1
P665,29,7,5,1,1,22,5,16,1
P666,34,25,17,5,3,9,2,6,1
P667,32,14,9,4,1,18,7,10,1
E728,28,21,11,9,1,7,2,5,0
E729,30,15,10,2,3,15,4,10,1
E722,29,23,14,9,0,6,1,4,1
E723,30,11,8,2,1,19,5,13,1
E720,28,22,15,7,0,6,2,3,1
E721,32,26,15,7,4,6,2,3,1
E726,28,12,8,4,0,16,6,9,1
E727,28,10,7,2,1,18,6,11,1
E724,29,12,7,3,2,17,5,9,3
E725,28,21,11,8,2,7,3,4,0
M722,31,16,12,2,2,15,3,8,4
M723,32,17,12,5,0,15,4,8,3
M720,32,19,14,4,1,13,3,8,2
M721,33,22,14,4,4,11,3,6,2
M726,30,6,3,2,1,24,12,10,2
M727,30,20,10,8,2,10,3,6,1
M724,31,23,11,8,4,8,1,6,1
M725,31,18,12,5,1,13,3,7,3
M728,31,13,9,4,0,18,8,10,0
M729,31,15,13,2,0,16,4,8,4
L743,30,8,6,2,0,22,10,11,1
L742,30,14,8,2,4,16,5,9,2
L741,31,17,10,4,3,14,4,8,2
L740,28,6,4,1,1,22,5,13,4
L747,30,13,9,4,0,17,4,12,1
L746,28,9,7,2,0,19,8,9,2
L745,27,16,10,6,0,11,4,7,0
L744,31,16,8,7,1,15,5,9,1
L749,32,26,12,10,4,6,0,4,2
L748,30,6,4,2,0,24,8,13,3
F648,28,12,8,4,0,16,5,10,1
F644,28,12,7,4,1,16,5,10,1
F645,25,10,6,3,1,15,4,10,1
F646,8,4,1,3,0,4,0,4,0
F647,30,17,9,6,2,13,5,7,1
F640,31,22,13,6,3,9,1,7,1
F641,29,12,6,3,3,17,4,11,2
F642,26,10,5,4,1,16,5,9,2
F643,26,8,7,1,0,18,5,13,0
G801,28,13,7,5,1,15,7,6,2
G800,28,18,9,8,1,10,2,6,2
G803,26,16,8,5,3,10,2,8,0
G802,31,25,13,9,3,6,3,2,1
G805,30,13,11,1,1,17,4,10,3
G804,28,11,8,3,0,17,3,11,3
G807,30,20,9,7,4,10,2,5,3
G809,28,16,11,5,0,12,4,8,0
G808,25,7,3,4,0,18,7,10,1
J738,28,7,6,0,1,21,9,10,2
J739,26,9,6,3,0,17,5,12,0
J734,28,5,2,3,0,23,9,13,1
J736,27,14,7,5,2,13,3,10,0
J737,30,13,8,4,1,17,8,6,3
J730,30,16,8,3,5,14,3,8,3
J731,28,20,13,6,1,8,4,3,1
J732,29,14,7,5,2,15,5,8,2
J733,26,17,11,6,0,9,2,7,0
C678,32,16,10,4,2,16,4,8,4
C679,27,4,3,1,0,23,10,13,0
C672,25,16,8,8,0,9,3,6,0
C673,30,15,12,2,1,15,6,8,1
C670,31,23,12,6,5,8,3,5,0
C671,27,20,12,8,0,7,3,3,1
C676,31,17,15,0,2,14,2,10,2
C677,25,7,5,2,0,18,5,13,0
C674,28,22,14,7,1,6,0,5,1
C675,29,14,8,4,2,15,6,7,2
C580,25,9,5,4,0,16,5,11,0
C581,28,19,10,6,3,9,1,8,0
C582,26,15,10,3,2,11,2,9,0
C583,26,9,6,3,0,17,6,11,0
C585,11,4,1,3,0,7,0,6,1
C586,25,9,7,2,0,16,3,13,0
C587,29,14,10,3,1,15,5,9,1
C588,28,22,12,10,0,6,1,5,0
C589,27,12,8,3,1,15,4,11,0
P853,31,24,14,8,2,7,1,4,2
P852,29,8,8,0,0,21,7,11,3
P851,31,17,12,5,0,14,3,8,3
P850,33,21,8,8,5,12,4,6,2
P855,28,7,7,0,0,21,7,14,0
P854,27,14,8,6,0,13,4,8,1
O830,31,15,11,2,2,16,6,8,2
O831,31,23,15,6,2,8,1,6,1
O832,25,6,4,2,0,19,6,13,0
O833,30,19,11,7,1,11,2,8,1
O834,27,10,5,5,0,17,7,9,1
O835,34,21,12,5,4,13,4,8,1
O836,32,17,11,3,3,15,3,10,2
O837,25,8,4,4,0,17,5,10,2
O838,31,5,2,2,1,26,11,14,1
O839,29,19,13,5,1,10,2,7,1
E540,28,12,6,6,0,16,8,7,1
E541,30,10,8,1,1,20,6,12,2
E546,32,17,9,5,3,15,3,8,4
E547,27,9,6,2,1,18,6,9,3
E544,30,25,13,8,4,5,1,4,0
C854,25,11,6,3,2,14,5,8,1
C855,27,18,9,9,0,9,3,6,0
C852,26,18,14,4,0,8,1,6,1
C853,29,22,13,5,4,7,1,5,1
C850,24,6,5,1,0,18,3,15,0
C851,27,9,5,4,0,18,7,11,0
G588,29,4,2,2,0,25,10,12,3
G589,29,12,7,4,1,17,6,11,0
I809,29,24,11,11,2,5,1,3,1
I808,27,10,7,2,1,17,4,12,1
I807,27,10,6,1,3,17,5,11,1
G585,27,11,8,1,2,16,2,13,1
I805,29,20,14,5,1,9,1,5,3
I804,28,13,10,2,1,15,1,13,1
I803,24,10,6,4,0,14,3,10,1
I802,29,9,7,2,0,20,7,11,2
I801,27,10,10,0,0,17,7,9,1
I800,28,23,9,10,4,5,1,3,1
Q608,28,4,1,3,0,24,8,15,1
H702,28,19,11,6,2,9,2,6,1
Q601,30,10,7,3,0,20,4,15,1
Q600,28,13,8,4,1,15,2,12,1
Q603,30,22,15,5,2,8,1,5,2
Q602,33,24,15,7,2,9,1,6,2
Q605,32,21,12,8,1,11,3,5,3
Q604,32,15,11,2,2,17,6,9,2
Q607,31,25,16,6,3,6,1,4,1
Q606,31,11,7,3,1,20,9,9,2
D558,24,8,5,3,0,16,4,10,2
D559,30,28,14,13,1,2,2,0,0
D556,30,16,12,2,2,14,3,8,3
D557,26,16,11,5,0,10,2,7,1
D554,27,25,11,11,3,2,0,1,1
D555,27,13,7,4,2,14,5,8,1
D552,26,12,8,4,0,14,5,8,1
D553,24,5,3,2,0,19,6,12,1
D550,23,5,3,2,0,18,7,10,1
D551,29,15,12,1,2,14,4,8,2
